read: reads read
level: levels level
sniff: sniff
overfill: overfill
electrocuted: electrocuted
tremendous: tremendous
cdc: cdc
sufficient: sufficient
local: local
vital: vital
toaster: toaster
rib: ribs
circulation: circulation
carlotta: carlotta
living: living
thread: thread threads
sometimes: sometimes
electrical: electrical
referral: referral referrals
tpft: tpft
sprouted: sprouted
location: location locations
dvmveterinarian: dvmveterinarian
athletic: athletic
backside: backside
ink: inks ink
lunchmeat: lunchmeat
husen: husen
stimulated: stimulated
indirectly: indirectly
dairy: dairy
damage: damages damage
rendezvous: rendezvous
manner: manner manners
progressively: progressively
entonces: entonces
theriogenology: theriogenology
campus: campus
mammal: mammals
automobile: automobile
vanish: vanish
chemical: chemical chemicals
link: links link
soda: sodas soda
involved: involved
deprived: deprived
drowning: drowning
legend: legend
wafer: wafer
referee: referees referee
practicing: practicing
quote: quote quotes
book: book books
focus: focuses focus
allotted: allotted
softening: softening
hop: hop
improve: improve
tube: tube tubes
riparian: riparian
asked: asked
lb: lb lbs
curly: curly
gauge: gauge
replay: replay
severely: severely
apologize: apologize
determines: determines
holiday: holidays
cruel: cruel
donate: donate
propellant: propellant
resilient: resilient
patching: patching
panic: panic
lyric: lyrics lyric
brunt: brunt
clichéd: clichéd
promotion: promotions promotion
exhaling: exhaling
anymore: anymore
affiliated: affiliated
stranded: stranded
rear: rear
watermeal: watermeal
chastised: chastised
autonomy: autonomy
fruit: fruit fruits
rescue: rescue rescues
emailing: emailing
journalism: journalism
drown: drown
ice: ice ices
stool: stool stools
hunting: hunting
communicate: communicate
heart: heart
joined: joined
sell: sell sells
unwrap: unwrap
likened: likened
strip: strip strips
know: knows know
puree: puree
need: need needs
five: five
décor: décor
balsa: balsa
loud: loud
useless: useless
celebrating: celebrating
twisting: twisting
latest: latest
accustomed: accustomed
intensive: intensive
aquarium: aquariums aquarium
text: text texts
modest: modest
disaster: disaster disasters
clinical: clinical
dental: dental
tempted: tempted
employment: employment
mere: mere
knowledgeable: knowledgeable
structure: structure structures
million: million
immediately: immediately
test: test tests
misting: misting
misspelled: misspelled
exhausted: exhausted
skew: skew
provides: provides
locate: locate
columbia: columbia
religious: religious
thickness: thickness
j: j
covering: covering
calculating: calculating
kilometer: kilometer kilometers
axon: axon
defense: defense defenses
anxious: anxious
consuming: consuming
temperate: temperate
safely: safely
compatible: compatible
alpha: alpha
whisk: whisk
aide: aide aides
mustard: mustard
junkyard: junkyards
step: steps step
screw: screws screw
exerts: exerts
rose: rose
drum: drum
congratulate: congratulate
end: end ends
human: human humans
e: es e
owner: owners owner
idroid: idroid
cleaning: cleaning
conclusion: conclusion
range: ranges range
peel: peel
greenish: greenish
agree: agree
raisin: raisins
cell: cell cells
indicator: indicators indicator
physician: physicians physician
biopsy: biopsy
stomach: stomach
episode: episode episodes
pork: pork
accountable: accountable
brilliant: brilliant
reproduction: reproduction
concept: concepts concept
pavement: pavement
purposefully: purposefully
factor: factor factors
peace: peace
vp: vp
shadow: shadows shadow
vast: vast
travel: travel travels
page: page pages
supplement: supplements supplement
gap: gap gaps
carrot: carrots
everything: everything
bumping: bumping
confront: confront
consciousness: consciousness
floating: floating
dislodged: dislodged
canner: canner
spinal: spinal
push: push
comedy: comedy
operating: operating
goody: goodies
quiet: quiet
boil: boils boil
pedal: pedals
outgoing: outgoing
shutter: shutter
klare: klare
rump: rump
tug: tug
tengas: tengas
daughter: daughter
foot: feet foot
queen: queen
modification: modification
denver: denver
squeal: squeals
arrives: arrives
parchment: parchment
rosacea: rosacea
walking: walking
brand: brand brands
transitionsーthat: transitionsーthat
quotev: quotev
caramelized: caramelized
wrist: wrist wrists
pas: pass
connection: connections connection
lather: lather
schrader: schrader
illness: illnesses illness
drying: drying
steak: steaks steak
hang: hangs hang
larger: larger
paste: paste
chess: chess
tendency: tendencies tendency
largely: largely
skittish: skittish
comparable: comparable
arm: arm arms
unprofessional: unprofessional
concern: concerns concern
fair: fair
bible: bible
passion: passions passion
spaced: spaced
pretend: pretend
smooth: smooth smooths
expands: expands
avail: avail
fin: fins fin
pan: pan
scotch: scotch
bisexual: bisexual
livestock: livestock
job: job jobs
meditation: meditation
coax: coax
fold: fold folds
persuade: persuade
growing: growing
spree: spree
uninhibited: uninhibited
thin: thin
powdered: powdered
harvester: harvesters
manage: manage
crooked: crooked
development: development
version: version versions
overbearing: overbearing
abdomen: abdomen
realize: realize
cleansing: cleansing
slang: slang
litter: litter
choreography: choreography
pod: pods pod
hearty: hearty
topped: topped
attentive: attentive
comfortably: comfortably
viewable: viewable
ranking: ranking
mint: mint
brine: brine
milligram: milligrams
endurance: endurance
thereby: thereby
dissolve: dissolve
positioned: positioned
surface: surface surfaces
reshaped: reshaped
skirt: skirt
involving: involving
risky: risky
mitt: mitt mitts
copying: copying
suffuse: suffuse
outerwear: outerwear
editor: editor editors
dumbbell: dumbbell
reaction: reaction reactions
helping: helping
kilogram: kilograms kilogram
narrower: narrower
traveling: traveling
plaster: plaster
tomato: tomatoes tomato
straighten: straighten
remains: remains
compatibility: compatibility
attachment: attachments attachment
clause: clause
cash: cash
reorder: reorder
calming: calming
sushi: sushi
dongle: dongle
delaware: delaware
allegation: allegations
policy: policy policies
separate: separate
socialize: socialize
virus: virus
psittacine: psittacine
thought: thought thoughts
distortion: distortion
author: authors author
refill: refill
ass: assesses assess
count: count
backhand: backhand
citruslover: citruslover
triceps: triceps
nature: nature
simmer: simmers simmer
condense: condense
saturday: saturday
michael: michael
accumulates: accumulates
secured: secured
breast: breast breasts
character: character characters
standby: standbys standby
punishment: punishment
ich: ich
lauren: lauren
food: food foods
designed: designed
slight: slight
pouring: pouring
quietly: quietly
closure: closure
broke: broke
rewarding: rewarding
knife: knife
ethanol: ethanol
monday: monday
specific: specifics specific
detergent: detergents detergent
oz: oz
rocky: rocky
ride: ride
parting: parting
little: little
fe: fe
summertime: summertime
performed: performed
primarily: primarily
stealth: stealth
others: others
leak: leaks leak
magic: magic
frontline: frontline
angry: angry
opposed: opposed
rod: rods rod
enzyme: enzymes
chatting: chatting
mol: mol
wozniczka: wozniczka
dying: dying
lake: lakes lake
implement: implement
land: lands land
confusion: confusion
art: arts art
deep: deep
corner: corner corners
afraid: afraid
chasing: chasing
clipping: clippings
perhaps: perhaps
writer: writer writers
intricately: intricately
generosity: generosity
nectar: nectar
information: information
slide: slides slide
banana: banana bananas
shuts: shuts
scented: scented
transform: transform
outburst: outbursts
infested: infested
bandage: bandage bandages
creamier: creamier
tree: tree trees
funny: funny
stucco: stucco
efficiently: efficiently
blended: blended
enclosed: enclosed
metalworker: metalworker
forth: forth
compete: compete
burning: burning
supposed: supposed
leverage: leverage
usa: usa
processing: processing
strives: strives
consequence: consequences consequence
contained: contained
desert: desert
subject: subject subjects
flap: flap
call: call calls
lose: lose
fiddle: fiddle
aisle: aisles aisle
inspire: inspire
specialist: specialist specialists
hire: hire
bike: bikes bike
setup: setup
alternative: alternatives alternative
pea: peas pea
dictate: dictate
depend: depend
persuasive: persuasive
jittery: jittery
texture: textures texture
earshot: earshot
shutoff: shutoff
shovel: shovel
dolphin: dolphin
morose: morose
hydroxy: hydroxy
skill: skills skill
simplest: simplest
hormonal: hormonal
bodily: bodily
amaranth: amaranth
taking: taking
introducing: introducing
definitely: definitely
gluten: gluten
diet: diets diet
exterior: exterior
return: returns return
app: app
package: package
mat: mats mat
directional: directional
couch: couch couches
opportunity: opportunities opportunity
overstimulated: overstimulated
healed: healed
handler: handlers handler
death: deaths death
unacceptable: unacceptable
spinach: spinach
wavy: wavy
burner: burner
cheaper: cheaper
fragile: fragile
minimize: minimize
silicone: silicone
signature: signature
updating: updating
rap: rap
dispel: dispel
overindulging: overindulging
truly: truly
combat: combat
blow: blows blow
sarcastic: sarcastic
cereal: cereal cereals
donkey: donkey
playdates: playdates
obtain: obtain
surrender: surrender
tear: tears tear
affectionate: affectionate
rgb: rgb
craving: craving
overwhelmed: overwhelmed
bloom: bloom blooms
manufacturer: manufacturer
urge: urge urges
pdf: pdf
response: response responses
confirming: confirming
luckily: luckily
repeated: repeated
scheduled: scheduled
retailer: retailer retailers
hoe: hoes
warmth: warmth
fashion: fashion
admire: admire
opportune: opportune
folded: folded
granted: granted
mug: mugs mug
danny: danny
waving: waving
powered: powered
bookstore: bookstores
playback: playback
recorded: recorded
weekend: weekends weekend
inhaling: inhaling
insecurity: insecurity
session: sessions session
beating: beating
boxer: boxers
pin: pins pin
candidate: candidates
confusing: confusing
master: masters master
lever: levers lever
decorative: decorative
pest: pest pests
negative: negative
bunny: bunny
repress: repress
outlook: outlook
todo: todo
challenging: challenging
leaving: leaving
housing: housing
shuffling: shuffling
wikihow: wikihow
camping: camping
ward: ward
hanger: hangers hanger
africa: africa
ln: ln
ignoring: ignoring
compound: compounds compound
conscientious: conscientious
marker: marker
rating: ratings rating
misjudging: misjudging
haggle: haggle
sharper: sharper
progression: progression
sporadic: sporadic
urban: urban
especially: especially
assert: assert
hope: hope
oxygen: oxygen
clasp: clasp
steam: steam
dismiss: dismiss
anticipating: anticipating
critter: critters
prevents: prevents
comprised: comprised
nothing: nothing
vet: vets vet
withdrawing: withdrawing
garbage: garbage
air: air
interstitial: interstitial
smores: smores
already: already
naked: naked
prairie: prairie
taxi: taxi
time: times time
discouraging: discouraging
strike: strikes strike
grain: grain grains
supreme: supreme
event: events event
practiced: practiced
fry: fry fries
network: network
dishonesty: dishonesty
weighing: weighing
put: put puts
aluminum: aluminum
wedge: wedge
mla: mla
minded: minded
behavior: behaviors behavior
tempting: tempting
peter: peters peter
juice: juice juices
tape: tape
printing: printing
phrase: phrase phrases
browser: browser
video: video videos
unsupervised: unsupervised
spawning: spawning
sweet: sweet sweets
piece: piece pieces
ringside: ringside
novel: novel
participating: participating
h: h
joke: jokes joke
misused: misused
snuggly: snuggly
manually: manually
distraction: distraction distractions
rainwater: rainwater
sketching: sketching
channel: channels
regulation: regulation regulations
entity: entity entities
attempt: attempt
cranberry: cranberry
pad: pad pads
stronger: stronger
suspension: suspension
root: root roots
troublesome: troublesome
churn: churn
loosening: loosening
content: content contents
expected: expected
loofah: loofah
cooker: cooker
structured: structured
hacked: hacked
droppings: droppings
shirt: shirt
immersion: immersion
sociable: sociable
fruiting: fruiting
autumn: autumn
fertilizing: fertilizing
perpetuate: perpetuate
bet: bets bet
deductible: deductible
load: loads load
embrace: embrace
abc: abc
proposal: proposal
congratulatory: congratulatory
combing: combing
frustrated: frustrated
blanching: blanching
pool: pools pool
phillip: phillip
molt: molts molt
magazine: magazine magazines
intrusive: intrusive
ability: abilities ability
river: river rivers
stew: stews stew
negating: negating
half: halves half
exfoliate: exfoliate
included: included
seated: seated
restriction: restrictions
belief: beliefs believes belief
airflow: airflow
status: status
language: language
pig: pigs pig
citation: citation citations
swap: swap
uploads: uploads
imprisonment: imprisonment
adjustable: adjustable
impeding: impeding
sued: sued
await: await
trigger: trigger triggers
prolong: prolong
scared: scared
sequenzia: sequenzia
encouragement: encouragement
kidney: kidneys kidney
security: security
tailor: tailor
exacerbate: exacerbate
traveled: traveled
grease: grease
camacademic: camacademic
enforce: enforce
institute: institute institutes
researching: researching
cam: cam
golf: golf
lee: lee
grip: grip
calculator: calculators
taut: taut
irs: irs
folding: folding
planting: planting
cabinet: cabinet cabinets
shot: shots shot
deglaze: deglaze
cooked: cooked
serve: serve
bushier: bushier
efficiency: efficiency
suitable: suitable
workout: workouts workout
kickball: kickball
crack: crack cracks
litigated: litigated
availing: availing
improvement: improvements improvement
visit: visits visit
stunt: stunts stunt
vomiting: vomiting
jaw: jaws jaw
pupil: pupils pupil
anchor: anchor
domain: domain
first: first
extent: extent
rid: rid
adjuster: adjuster
hunch: hunch hunches
solution: solution solutions
line: lines line
paralysis: paralysis
pasta: pastas pasta
stain: stain stains
fearful: fearful
emoticon: emoticons
persistence: persistence
working: working workings
database: database
convention: convention
exact: exact
emphasized: emphasized
ready: ready
sandwich: sandwich sandwiches
divider: dividers
scraping: scraping
hover: hover
del: del
disruption: disruption disruptions
affection: affection
written: written
ph: ph
prune: prunes prune
sign: sign signs
summarize: summarize
retirement: retirement
expert: expert experts
park: park
virginia: virginia
positively: positively
surety: surety
person: person persons
attic: attics
sleeker: sleeker
personally: personally
wait: wait
bright: bright
snack: snack snacks
earn: earn
doubt: doubts doubt
competing: competing
please: please
remain: remain
slot: slots slot
trend: trends
reproductive: reproductive
stock: stock
nymph: nymph nymphs
rather: rather
mfa: mfa
audience: audiences audience
aching: aching
inserted: inserted
home: home homes
returning: returning
soak: soak
stable: stable
length: lengths length
dresser: dresser
fabric: fabric fabrics
romantic: romantic
briefly: briefly
solidify: solidify
cinch: cinch
accumulate: accumulate
tissue: tissue tissues
extensive: extensive
valve: valves valve
presentation: presentation presentations
fainting: fainting
jump: jump jumps
refinance: refinance
humane: humane
overdo: overdo
capacity: capacity
brush: brush brushes
present: present
wood: woods wood
overgrowth: overgrowth
field: fields field
civil: civil
outright: outright
unused: unused
net: net
diner: diners
sat: sat
interrogating: interrogating
hutch: hutch
posted: posted
vertically: vertically
extraordinary: extraordinary
weighs: weighs
freedom: freedom
advantage: advantage
injury: injuries injury
deformed: deformed
secular: secular
dandruff: dandruff
conducting: conducting
stream: stream
memento: mementos
introduction: introduction
teammate: teammates
boat: boat
cleaned: cleaned
overlay: overlay overlays
baseball: baseball
caulk: caulk
family: families family
examine: examine
unfollowing: unfollowing
lengthy: lengthy
pushed: pushed
accompany: accompany
outfit: outfit outfits
chris: chris
exclamation: exclamation
updater: updater
momentarily: momentarily
electromyelography: electromyelography
insufficiency: insufficiency
antifungal: antifungal
analyze: analyze
grey: grey
command: commands command
success: success
contributed: contributed
dated: dated
lubricate: lubricate
without: without
flavorless: flavorless
base: base bases
aim: aim
overstepping: overstepping
bhattta: bhattta
amy: amy
reduces: reduces
disrespect: disrespect disrespects
triathlons: triathlons
yahoo: yahoo
usually: usually
headphone: headphones
uncontrolled: uncontrolled
presently: presently
accept: accept
drew: drew
flush: flush flushes
gaining: gaining
imidacloprid: imidacloprid
fund: funds fund
sanitary: sanitary
powder: powder powders
automatic: automatic
pond: pond
incorporate: incorporate
grimy: grimy
bend: bends bend
fewer: fewer
tile: tiles
heel: heel heels
organized: organized
album: albums album
image: images image
brightness: brightness
dioxide: dioxide
founder: founder
software: software
workplace: workplace
dish: dishes dish
host: host hosts
sticker: stickers sticker
vehicle: vehicles vehicle
easiest: easiest
occasion: occasions occasion
fatigued: fatigued
string: string
yeast: yeast
trade: trade
formatting: formatting
title: titles title
country: country countries
figuratively: figuratively
lay: lays lay
apron: apron
reparation: reparations
thing: thing things
hatchling: hatchlings
finishing: finishing
wedding: wedding
intel: intel
dessert: dessert desserts
nurtured: nurtured
replant: replant
tú: tú
sporting: sporting
continual: continual
employer: employer employers
reasonably: reasonably
vol: vol
david: david
bent: bent
irritating: irritating
safflower: safflower
cry: cries crying cry
dot: dot dots
greedy: greedy
obligation: obligation
structurally: structurally
grime: grime
wrench: wrench
orange: oranges orange
yolk: yolk
spelt: spelt
isolation: isolation
pp: pp
mixture: mixture mixtures
indicates: indicates
check: check checks
visiting: visiting
matting: matting
respect: respects respect
constructed: constructed
preventative: preventative
stemware: stemware
undercooked: undercooked
dress: dress
scorch: scorch
stiff: stiff
estimation: estimation
creation: creation
pesky: pesky
detect: detect
liquid: liquids liquid
nlp: nlp
misbehaves: misbehaves
wearing: wearing
collaborating: collaborating
stylist: stylist
vu: vu
electronic: electronic
navigate: navigate
desired: desired
price: prices price
consulate: consulate
indoor: indoor
green: greens green
laying: laying
press: press
amazon: amazon
rica: rica
stimulates: stimulates
drama: drama
percentage: percentage percentages
taste: taste tastes
spatula: spatula
ball: ball balls
quick: quick
interrupting: interrupting
shopped: shopped
dark: dark darks
rejected: rejected
mummy: mummies
social: socials social
representation: representation
city: cities city
move: moves move
involve: involve
soil: soil soils
cornered: cornered
laura: laura
rank: rank ranks
mutual: mutual
benign: benign
proliferation: proliferation
police: police
flowing: flowing
stun: stun
respectful: respectful
thinner: thinner
compare: compare
miscommunications: miscommunications
apply: apply
tangled: tangled
roof: roof roofs
nutty: nutty
healing: healing
fennel: fennel
atkinson: atkinson
scold: scold
toenail: toenail toenails
comma: comma
deteriorated: deteriorated
locker: locker
trick: tricks trick
quality: quality
bathmats: bathmats
muscle: muscle muscles
rd: rd
rigorous: rigorous
complaining: complaining
reinstallation: reinstallation
adhering: adhering
maintain: maintain
decide: decide
noise: noises noise
helper: helper
spurt: spurts
invested: invested
dirty: dirty
middle: middle
doctor: doctors doctor
stray: stray
nurse: nurses nurse
break: break breaks
solely: solely
readjust: readjust
evaluator: evaluator
like: like likes
consists: consists
filming: filming
attorney: attorney attorneys
maid: maids
collection: collection collections
excerpt: excerpt excerpts
barefoot: barefoot
relate: relate
lug: lugs
story: story stories
urine: urine
afforded: afforded
teaspoon: teaspoons teaspoon
securely: securely
shape: shape shapes
parrot: parrots parrot
spring: spring springs
corresponds: corresponds
locating: locating
help: help helps
facilitate: facilitate
alphabetical: alphabetical
con: con
affecting: affecting
maintenance: maintenance
fail: fail
lawn: lawn lawns
afectuosamente: afectuosamente
zone: zone zones
bathroom: bathroom
torso: torso
law: laws law
interaction: interactions interaction
talent: talent
unclear: unclear
famous: famous
workshop: workshops workshop
headgear: headgear
hydrated: hydrated
clipper: clippers
joint: joint
waiting: waiting
gelatinous: gelatinous
private: private
elbow: elbows
double: doubles double
isaac: isaac
pubmed: pubmed
contestant: contestants
affect: affect affects
love: loves love
question: questions question
acknowledges: acknowledges
supervise: supervise
apart: apart
destruction: destruction
sending: sending
tracing: tracing
flathead: flathead
settle: settles settle
locking: locking
chance: chance chances
batter: batters
towel: towels towel
join: joins join
diamond: diamond diamonds
retighten: retighten
resting: resting
cox: cox
pee: pee
rearrange: rearrange
medium: medium mediums media
special: special
property: property properties
ash: ash
performer: performers
obtained: obtained
plumb: plumb
relaxing: relaxing
blade: blade blades
month: month months
popularize: popularize
shy: shy
member: member members
cerebral: cerebral
shoe: shoe shoes
bean: bean beans
groove: grooves groove
isolated: isolated
island: island
dilute: dilute
part: parts part
final: final
mechanism: mechanisms mechanism
stick: sticks stick
accessibility: accessibility
attach: attach
choosing: choosing
supplier: supplier
distracting: distracting
dismantling: dismantling
nutritional: nutritional
grooved: grooved
score: score
chiding: chiding
accompanying: accompanying
seat: seats seat
association: association associations
article: article
york: york
chronic: chronic
chau: chau
relaxed: relaxed
tool: tools tool
coupled: coupled
ulcer: ulcers ulcer
average: average averages
faq: faq
dial: dials dial
underdressing: underdressing
list: lists list
brain: brain brains
implementing: implementing
direction: directions direction
harbor: harbor
glass: glass glasses
cider: cider
paracord: paracord
formulate: formulate
terminal: terminals
trudi: trudi
piping: piping
acid: acid acids
complement: complements
breakout: breakouts
dipping: dipping
power: powers power
bathwater: bathwater
typhoid: typhoid
crump: crump
circulate: circulate
font: fonts font
casket: casket
suppose: suppose
neighborhood: neighborhood
charisma: charisma
permethrin: permethrin
tea: tea
advice: advice
qualifying: qualifying
misalignment: misalignment
germinating: germinating
glove: gloves
purify: purify
reliant: reliant
hungry: hungry
unaffected: unaffected
repeatedly: repeatedly
luba: luba
scum: scum
useful: useful
style: style styles
stitch: stitch
january: january
candy: candy candies
accordingly: accordingly
emergency: emergency emergencies
chopping: chopping
lip: lips lip
panel: panels panel
wrapped: wrapped
vaccinate: vaccinate
accident: accidents accident
application: application applications
odd: odd
sought: sought
linen: linens linen
discard: discard
stumbling: stumbling
dentist: dentist
dimension: dimensions dimension
changing: changing
touching: touching
elementary: elementary
needlessly: needlessly
crumbling: crumbling
upset: upsets upset
upsetting: upsetting
monthly: monthly
tract: tract tracts
stalk: stalk stalks
instruction: instruction instructions
broccoli: broccoli
digitally: digitally
fishing: fishing
glue: glue glues
club: clubs club
hole: holes hole
free: free frees
item: items item
waterer: waterers
incentive: incentive
surfing: surfing
independently: independently
gmail: gmail
millimeter: millimeter millimeters
potentially: potentially
stammering: stammering
mantra: mantra
visible: visible
palm: palms palm
sunglass: sunglasses
prevented: prevented
surge: surge
door: door doors
thaw: thaw
playtime: playtime
paratyphoid: paratyphoid
blatta: blatta
gesticulation: gesticulation
fly: fly flies
privilege: privilege
cultural: cultural
doppler: doppler
confidential: confidential
sadness: sadness
sweat: sweat
loading: loading
rain: rain rains
changeable: changeable
picked: picked
believe: believe
mart: mart
can: cans
artwork: artwork
moving: moving
discussing: discussing
report: report reports
hyperactivity: hyperactivity
piling: piling
ease: ease
snapchat: snapchat
goal: goal goals
disastrous: disastrous
spontaneous: spontaneous
gummed: gummed
partner: partners partner
teachable: teachable
standard: standards standard
vista: vista
concluding: concluding
momentous: momentous
combination: combination combinations
insurance: insurance
nylar: nylar
register: register
thrust: thrusts
faking: faking
achieve: achieve
brag: brag
involvement: involvement
phosphate: phosphates
roll: rolls roll
gastrointestinal: gastrointestinal
facial: facial
untrained: untrained
quantity: quantities quantity
budget: budget
zip: zip
guarana: guarana
uncharacteristic: uncharacteristic
dressing: dressing dressings
landscape: landscapes landscape
volume: volumes volume
hissing: hissing
awl: awl
touched: touched
sam: sam
bill: bills bill
rub: rub rubs
cotton: cotton
prying: prying
colitis: colitis
walker: walker
centimetre: centimetres
namely: namely
matchmaker: matchmaker
storage: storage
adventurous: adventurous
picture: picture pictures
established: established
complication: complications
carport: carports
another: another
bound: bound
traveler: traveler travelers
hate: hate hates
competes: competes
flair: flair
problematic: problematic
garlic: garlic
oiling: oiling
bond: bonds bond
increasing: increasing
prosecution: prosecution
dropping: dropping
provider: provider
relieving: relieving
http: https http
arriving: arriving
motivates: motivates
originates: originates
frenchtown: frenchtown
pillow: pillows pillow
concierge: concierge
gut: gut
separately: separately
feel: feels feel
transmitting: transmitting
allodynia: allodynia
overdressing: overdressing
letter: letter letters
donating: donating
fact: fact facts
deadline: deadline
staged: staged
injuring: injuring
temperature: temperature temperatures
cream: creams cream
earned: earned
tasty: tasty
verified: verified
rotate: rotate
flustered: flustered
inappropriate: inappropriate
cutrine: cutrine
whilst: whilst
firmly: firmly
convincing: convincing
weird: weird
crosswise: crosswise
biggest: biggest
straight: straight
yes: yes
normal: normal
sibling: siblings
finder: finder finders
sweaty: sweaty
proliferate: proliferate
outwards: outwards
pinpointed: pinpointed
principle: principle
hitch: hitch
jessica: jessica
unproven: unproven
crucial: crucial
nitrate: nitrates nitrate
president: president
angle: angle angles
mound: mound
post: posts post
moroccan: moroccan
maintains: maintains
twin: twin
loose: loose
greeting: greeting greetings
acidic: acidic
cm: cm
sir: sir
pick: picks pick
chastising: chastising
lawsuit: lawsuit lawsuits
exhale: exhale
bacon: bacon
scripted: scripted
acrylic: acrylic
conversely: conversely
gooey: gooey
endorphin: endorphins
youth: youth
winning: winning
clarification: clarification
technically: technically
repairing: repairing
whose: whose
dampness: dampness
sexing: sexing
including: including
cooperative: cooperative
trichofolliculoma: trichofolliculoma
losing: losing
throw: throw throws
refurbished: refurbished
arbitrary: arbitrary
switching: switching
joe: joe
mentally: mentally
peeling: peelings peeling
recognizable: recognizable
planner: planner
probiotic: probiotics
sweetness: sweetness
street: streets street
giggle: giggle
truck: truck
coffee: coffee
relatively: relatively
patch: patch patches
bassline: bassline
wheat: wheat
overhanging: overhanging
fryer: fryers fryer
appointed: appointed
published: published
camera: cameras camera
context: context contexts
control: control controls
burst: burst bursts
tall: tall
heavily: heavily
disallow: disallow
except: except
cussing: cussing
capsule: capsule capsules
suffered: suffered
radiation: radiation
acne: acne
bios: bios
labor: labor
repair: repairs repair
dub: dubs dub
utensil: utensils utensil
reset: reset
begun: begun
philliphandyman: philliphandyman
paw: paw
moment: moment moments
pale: pale
pitch: pitch
mg: mg
damaged: damaged
tying: tying
cool: cool cools
harvard: harvard
adolescent: adolescent
applying: applying
display: displays display
mucosa: mucosa
maple: maple
familiarize: familiarize
flu: flu
establish: establish
structural: structural
lethal: lethal
halloween: halloween
fluorescent: fluorescent
yank: yank
cover: covers cover
personalized: personalized
sparingly: sparingly
scooping: scooping
smelling: smelling
sphagnum: sphagnum
nocturnal: nocturnal
valley: valley
calculated: calculated
mcclure: mcclure
dire: dire
commuting: commuting
rhythmically: rhythmically
noticed: noticed
outlined: outlined
accommodation: accommodations
quit: quit
instead: instead
el: el
ordinary: ordinary
upload: upload
versa: versa
forgotten: forgotten
atentamente: atentamente
charge: charge charges
suspected: suspected
commit: commit
well: well wells
luna: luna
experience: experiences experience
chewing: chewing
summary: summary
consecutively: consecutively
presuming: presuming
remedy: remedies remedy
suddenly: suddenly
startup: startup
berne: berne
supply: supplies supply
set: set sets
lawyer: lawyers lawyer
setting: settings setting
meeting: meeting meetings
hair: hair hairs
bomb: bomb bombs
guessed: guessed
disregard: disregard
ruin: ruin
pruning: pruning
layer: layer layers
beware: beware
mattress: mattress
stringing: stringing
open: opens open
marathon: marathon
nematode: nematodes
insect: insect insects
cruelty: cruelty
game: games game
pickup: pickup
develop: develop
grassy: grassy
nervousness: nervousness
february: february
insert: inserts insert
sue: sue
underwear: underwear
blot: blot
sent: sent
premise: premises
hamster: hamsters hamster
produced: produced
marinade: marinade marinades
walmart: walmart
competition: competition
caffeine: caffeine
irritable: irritable
curb: curb
fade: fade
presented: presented
ingredient: ingredients ingredient
boredom: boredom
message: messages message
fomo: fomo
blanched: blanched
finalizes: finalizes
foundation: foundation
toilet: toilet
search: searches search
pinky: pinky
phd: phd
ebay: ebay
clock: clocks clock
impulse: impulses
addressing: addressing
import: import
receiving: receiving
reboot: reboot
protective: protective
speaker: speakers speaker
negativity: negativity
organ: organs organ
bob: bobs bob
ideal: ideal
compact: compact
shower: showers shower
outdoors: outdoors
various: various
center: center centers
eating: eating
early: early
stir: stir stirs
parasite: parasite parasites
design: designs design
menu: menu menus
rounder: rounder
precious: precious
depth: depths depth
frequented: frequented
pushing: pushing
cook: cooks cook
lean: lean
infringed: infringed
absorbed: absorbed
decimal: decimals
marshmallow: marshmallows marshmallow
deal: deal deals
antibacterial: antibacterial
fuller: fuller
scheduling: scheduling
jumbo: jumbo
sleek: sleek
alienated: alienated
failing: failing
start: start starts
nada: nada
addressee: addressee
revocation: revocation
wednesday: wednesday
year: years year
impossible: impossible
process: processes process
group: group groups
impregnate: impregnate
plug: plug plugs
worker: worker workers
marusinec: marusinec
healthy: healthy
one: one ones
coupon: coupon coupons
puncture: puncture
force: force forces
schooler: schooler
sautee: sautee
tone: tone
criticism: criticism criticisms
repurposing: repurposing
assistance: assistance
probable: probable
circular: circular
understanding: understanding
bait: bait baits
soft: soft
disagreement: disagreements disagreement
adderall: adderall
repurpose: repurpose
spilling: spilling
sawfly: sawflies
regard: regards
zero: zero
vinegar: vinegar
exerted: exerted
drink: drinks drink
infected: infected
tenth: tenth
groomer: groomer
board: board boards
driftwood: driftwood
tai: tai
shipping: shipping
backwards: backwards
sturdier: sturdier
panicking: panicking
current: current currents
bottom: bottoms bottom
interacting: interacting
riding: riding
pay: pay pays
multiply: multiply
excessive: excessive
bear: bear
heat: heat heats
wrongly: wrongly
include: include
water: water waters
antibody: antibodies
athlete: athletes athlete
narrowed: narrowed
swing: swing swings
category: category categories
width: width
google: google
wrap: wrap
adhesive: adhesive adhesives
weakness: weakness weaknesses
butt: butt
pole: pole
chin: chin chins
confused: confused
hourly: hourly
xbox: xbox
succeeding: succeeding
hear: hear
empty: empty
assertively: assertively
successfully: successfully
admin: admin
provide: provide
input: input
spread: spreads spread
vanna: vanna
career: career
bath: baths bath
extremely: extremely
begin: begin begins
color: color colors
pester: pester
calm: calm calms
brainstorm: brainstorm
dehydrators: dehydrators
eyewear: eyewear
mixing: mixing
cytomegalovirus: cytomegalovirus
lock: lock
unfortunately: unfortunately
meat: meat meats
cyan: cyan
analyzer: analyzer
fleshy: fleshy
refrigerator: refrigerator
sprinkle: sprinkle
ritual: rituals ritual
forked: forked
shelf: shelf shelves
interested: interested
permanent: permanent
bin: bins bin
evolve: evolve
chocolate: chocolate chocolates
ken: ken
training: training
enrolling: enrolling
pant: pants
dramatically: dramatically
figure: figures figure
lifestyle: lifestyle
anything: anything
hypothyroidism: hypothyroidism
tabletop: tabletop tabletops
college: colleges college
hsing: hsing
flourish: flourish
generic: generic
diabetes: diabetes
ingestion: ingestion
delayed: delayed
constitutes: constitutes
cable: cables cable
marketplace: marketplaces
salad: salad salads
guideline: guidelines guideline
reveal: reveal
stressed: stressed
neither: neither
university: university universities
lie: lie lies
reviewer: reviewers reviewer
yogurt: yogurt
obsessed: obsessed
capstar: capstar
multiplier: multiplier
tolerate: tolerate
disadvantage: disadvantage
attractive: attractive
two: two
unaware: unaware
supervisor: supervisor
highway: highways
tread: treads
usual: usual
hostile: hostile
appraised: appraised
sick: sick
date: date dates
origin: origin
feature: feature features
genitalia: genitalia
knot: knot knots
backspace: backspace
cd: cd
specialization: specialization
rehash: rehash
whip: whip
ibd: ibd
ensures: ensures
spaghetti: spaghetti
openoffice: openoffice
rack: rack
tweezer: tweezers
moisten: moisten
option: option options
fitness: fitness
saving: saving savings
misaligned: misaligned
screen: screens screen
threading: threading
translate: translate
assign: assign
heater: heaters heater
hosting: hosting
creating: creating
tradeoff: tradeoff
meaningful: meaningful
possibility: possibilities possibility
dealer: dealer dealers
frightened: frightened
african: african
boosting: boosting
forget: forget
undoubtedly: undoubtedly
polished: polished
connecting: connecting
plastic: plastic
penetrate: penetrate
stochiometric: stochiometric
trainer: trainer
red: red
erik: erik
interview: interviews interview
chafe: chafe
boylls: boylls
melt: melt melts
head: head heads
salmon: salmon
exit: exit exits
controlled: controlled
handwrite: handwrite
schoolers: schoolers
dirtied: dirtied
block: block blocks
walk: walk walks
birth: birth
flatbread: flatbread
insurer: insurer insurers
portion: portion portions
hangover: hangover
procedure: procedure procedures
disorder: disorders
exposing: exposing
incredibly: incredibly
onset: onset
capable: capable
place: place places
parenthesis: parenthesis parentheses
publication: publications publication
influx: influx
dissuade: dissuade
activate: activate
underpinnings: underpinnings
energized: energized
receptive: receptive
uncared: uncared
theory: theory
unpredictable: unpredictable
pacing: pacing
catastrophic: catastrophic
clicking: clicking
improved: improved
bench: benches bench
needed: needed
suit: suit suits
destroy: destroy
hairstyle: hairstyle
danger: danger dangers
duck: duck ducks
pure: pure
charismatic: charismatic
exercise: exercises exercise
affording: affording
minute: minutes minute
rule: rule rules
adjusting: adjusting
cleanup: cleanup
deter: deter
linger: linger
skating: skating
salifert: salifert
transcript: transcript
marinate: marinate
iso: iso
yet: yet
bad: bad
exposed: exposed
sensation: sensation sensations
lifesaving: lifesaving
injurious: injurious
parallel: parallel
aspca: aspca
delicious: delicious
suffering: suffering
area: areas area
yard: yard yards
fallible: fallible
vin: vin
finger: finger fingers
engaging: engaging
quadruple: quadruple
targeted: targeted
way: ways way
climb: climb
side: sides side
sting: sting
treatment: treatment treatments
compromise: compromise
hardness: hardness
premature: premature
descriptive: descriptive
request: requests request
mark: mark
cow: cow
hypersensitive: hypersensitive
fraternity: fraternities
gmp: gmp
constructive: constructive
deduction: deductions deduction
francisco: francisco
upbeat: upbeat
suspending: suspending
action: action actions
capture: capture
reconsider: reconsider
aureus: aureus
bank: banks bank
microscope: microscope
cheek: cheeks cheek
alive: alive
railroad: railroad
objective: objective objectives
highly: highly
cultivation: cultivation
arrival: arrival arrivals
disagree: disagree
fifty: fifty
division: division
bored: bored
shrink: shrinks shrink
pantyhose: pantyhose
bianca: bianca
typhi: typhi
capturing: capturing
sai: sai
personality: personality
openly: openly
argument: argument arguments
squarely: squarely
shiny: shiny
mph: mph
intermittent: intermittent
worldwide: worldwide
obedience: obedience
role: role roles
kill: kill kills
dumb: dumb
mode: mode
emulsion: emulsion
deficiency: deficiencies deficiency
seasoning: seasonings seasoning
stocked: stocked
seized: seized
balanced: balanced
impact: impact impacts
armrest: armrest
twelve: twelve
commitment: commitment
amount: amount amounts
downward: downward
concomitant: concomitant
determining: determining
spaying: spaying
aging: aging
triunfo: triunfo
successful: successful
integrated: integrated
fluid: fluid fluids
hosted: hosted
difficult: difficult
unkind: unkind
transition: transition transitions
unconscious: unconscious
flex: flex
deadheading: deadheading
zoom: zoom
mayonnaise: mayonnaise
infestation: infestation infestations
impaired: impaired
sexual: sexual
worth: worth
leash: leash
outpost: outpost outposts
justifying: justifying
took: took
phenazopyridine: phenazopyridine
vague: vague
next: next
bottle: bottles bottle
intend: intend
listing: listing
ill: ill
saucepan: saucepan
night: nights night
explicit: explicit
importance: importance
cleaner: cleaner cleaners
case: case cases
movie: movies movie
nose: nose
toothpaste: toothpaste
lump: lumps lump
m: ms
racing: racing
heated: heated
comeback: comeback
thirst: thirst
fried: fried
teeth: teeth
medicine: medicines medicine
november: november
weaker: weaker
charcoal: charcoal
remaining: remaining
note: notes note
kamut: kamut
attracted: attracted
insecticide: insecticide insecticides
america: america
sealant: sealant
broader: broader
canning: canning
sluggish: sluggish
latch: latch
herpes: herpes
deepen: deepen
weapon: weapons weapon
computer: computer computers
contract: contract
topic: topics topic
sweater: sweater sweaters
tricky: tricky
trimmed: trimmed
avocado: avocado avocados
blank: blank
widely: widely
opposite: opposite
relief: relief
error: error errors
crossing: crossing
reshape: reshape
cricothyroid: cricothyroid
torch: torch
show: shows show
progressive: progressive
dye: dye dyes
unnecessary: unnecessary
edge: edges edge
pilate: pilates
frustrating: frustrating
acknowledge: acknowledge
canteen: canteen
steep: steep
customer: customer
cinnamon: cinnamon
settled: settled
overdose: overdose
clue: clues
underlying: underlying
tropic: tropics
flashlight: flashlight
slowing: slowing
raspberry: raspberry raspberries
notified: notified
jellyfish: jellyfish
figured: figured
poured: poured
meet: meets meet
furthermore: furthermore
veggie: veggies veggie
decent: decent
via: via
fortunately: fortunately
searching: searching
blossom: blossom
intent: intent
backward: backward
immediate: immediate
oil: oil oils
overview: overview
attending: attending
recorder: recorder
till: till
licensed: licensed
germinate: germinate
tap: tap taps
colleague: colleague colleagues
handled: handled
bullying: bullying
rest: rests rest
lot: lot lots
lowest: lowest
certificate: certificate
classic: classic
tartar: tartar
fortified: fortified
circadian: circadian
exuding: exuding
research: research
chewed: chewed
advertise: advertise
withdraws: withdraws
permit: permit permits
taco: tacos taco
microphone: microphone microphones
urinating: urinating
toasted: toasted
unsuitably: unsuitably
wound: wounds
footstep: footsteps
rocking: rocking
forcing: forcing
proof: proof
weaken: weaken
biking: biking
darkness: darkness
repetitive: repetitive
detaches: detaches
cognitive: cognitive
booster: boosters booster
criterion: criteria
varies: varies
consider: consider
letting: letting
checker: checker
desktop: desktop
problem: problem problems
synthetic: synthetic
dividing: dividing
wrenching: wrenching
thesis: thesis
asking: asking
informally: informally
function: functions function
heartbeat: heartbeat
citizen: citizens citizen
recovered: recovered
regime: regime
beyond: beyond
sodium: sodium
left: left
appointment: appointment appointments
surprising: surprising
hard: hard
wake: wake
realized: realized
regressive: regressive
cite: cite
unparalleled: unparalleled
fairly: fairly
cleanest: cleanest
season: seasons season
syntax: syntax
safer: safer
frog: frogs
hyperactive: hyperactive
purchased: purchased
vagina: vagina
scene: scene scenes
harness: harness
inconsistently: inconsistently
ticket: ticket tickets
key: keys key
aimlessly: aimlessly
pictured: pictured
practice: practices practice
sense: sense
dip: dip dips
mighty: mighty
perspiring: perspiring
crushing: crushing
spare: spare
orientation: orientation
understood: understood
pulled: pulled
perceive: perceive
cod: cod
inject: inject
effort: efforts effort
together: together
biting: biting
sooner: sooner
peppermint: peppermint
introduced: introduced
concentration: concentrations concentration
sealed: sealed
horizontally: horizontally
material: material materials
faster: faster
deposited: deposited
guinea: guinea
raised: raised
crease: crease
sharp: sharp
permanence: permanence
gently: gently
detox: detox
speedometer: speedometer
freeze: freeze freezes
nutrient: nutrients
x: x
ridge: ridges ridge
jd: jd
unless: unless
zealand: zealand
lab: lab
ups: ups
sewer: sewer
directed: directed
finely: finely
shake: shake shakes
credible: credible
wish: wish wishes
pattern: patterns pattern
sun: sun
ii: ii
lubricant: lubricants lubricant
spine: spine
treating: treating
loses: loses
starting: starting
performing: performing
oneself: oneself
employee: employee employees
tightness: tightness
sooth: sooth
speed: speed speeds
blunder: blunder
circulating: circulating
portray: portray
co: co
complicated: complicated
reader: reader readers
drain: drain
clarity: clarity
pierce: pierce
therapy: therapy therapies
bracelet: bracelet
illegal: illegal
revise: revise
mimicking: mimicking
theobroma: theobroma
hinder: hinder
suspect: suspect suspects
found: found
casually: casually
thinking: thinking
reflecting: reflecting
guiding: guiding
opacity: opacity
letterhead: letterhead
dmd: dmd
moisturize: moisturize
greased: greased
dinner: dinner dinners
plainly: plainly
spray: sprays spray
lawler: lawler
saga: saga
workspace: workspace
fitting: fitting
ring: rings ring
want: want wants
judgmental: judgmental
exciting: exciting
ratio: ratio
quite: quite
undoing: undoing
snuck: snuck
pump: pumps pump
ca: ca
hook: hooks hook
addictive: addictive
porch: porch
tribute: tribute
chord: chord
wider: wider
bridge: bridge
expertise: expertise
preferably: preferably
evaluation: evaluation
developed: developed
adjusts: adjusts
payment: payments payment
tapping: tapping
leaning: leaning
petal: petals
dampened: dampened
irritant: irritants
narrow: narrows narrow
cooperation: cooperation
gaming: gaming
unplanned: unplanned
peak: peak
pursing: pursing
airport: airport airports
mole: mole moles
outpatient: outpatient
adopting: adopting
reliever: relievers
approach: approach
courage: courage
popped: popped
vas: vases
beg: beg
dappled: dappled
hydration: hydration
mercury: mercury
shrunk: shrunk
inedible: inedible
essentially: essentially
muñoz: muñoz
passed: passed
randomly: randomly
contingency: contingency
might: might
obesity: obesity
pm: pm
toast: toast
sequence: sequence
sloppy: sloppy
drill: drill drills
shivering: shivering
recognize: recognize
finish: finish finishes
formula: formula formulas
submissive: submissive
vegetation: vegetation
spay: spay
round: rounds round
get: get gets
collar: collar collars
hilly: hilly
washed: washed
toothed: toothed
unit: units unit
flat: flat
basically: basically
tailgating: tailgating
navigator: navigator
dedicated: dedicated
associate: associate
complex: complex
carrier: carrier
tourist: tourists
capital: capital
oat: oats
scratch: scratch scratches
appliance: appliance
champ: champs
withdrawal: withdrawal
coach: coach
math: math
untruthful: untruthful
existing: existing
specialized: specialized
overheating: overheating
proper: proper
filing: filing filings
celiac: celiac
correctly: correctly
definitively: definitively
haunt: haunt
linear: linear
acceptable: acceptable
spatter: spatter
welfare: welfare
chunky: chunky
duet: duet
regional: regional
facilitated: facilitated
strength: strengths strength
jerky: jerky
predict: predict
boiler: boiler
intake: intake
good: goods good
lighten: lighten
entertain: entertain
investigate: investigate
lung: lungs lung
reach: reaches reach
abandonment: abandonment
illustration: illustration
disrupts: disrupts
rudely: rudely
cricket: crickets cricket
rooted: rooted
algorithm: algorithm
runny: runny
oh: oh
d: ds
surround: surround
waste: waste
biological: biological
handle: handle handles
raising: raising
covered: covered
solid: solid
fluctuate: fluctuate
discussion: discussion discussions
humidifier: humidifier
administrative: administrative
offspring: offspring
cut: cut cuts
breeder: breeder breeders
dull: dull
existence: existence
sleepy: sleepy
inspected: inspected
retainer: retainer
main: main
processor: processor
mile: mile miles
pressure: pressure pressures
reflect: reflect
leaf: leaf leaves
column: columns column
gain: gains gain
tu: tu
tried: tried
hurt: hurts hurt
poop: poop
browning: browning
label: label labels
krona: krona
hill: hills
state: state states
chain: chain
lukewarm: lukewarm
cmd: cmd
o: os
forwarding: forwarding
hand: hand hands
attract: attract
affixing: affixing
screened: screened
hiv: hiv
known: known
fastened: fastened
insecticidal: insecticidal
assemble: assemble
opener: opener
smoker: smoker smokers
stepping: stepping
landline: landline
mouthwatering: mouthwatering
trampoline: trampolines
comfortable: comfortable
guest: guest guests
tailored: tailored
showcasing: showcasing
couple: couple couples
eo: eo
minuscule: minuscule
socially: socially
extreme: extreme
program: program programs
born: born
toothache: toothache
fridge: fridge
lupron: lupron
puffy: puffy
noting: noting
dear: dear
rash: rash
james: james
description: description descriptions
grievance: grievances
seemed: seemed
cling: cling
andrew: andrew
responding: responding
ankle: ankles ankle
emerge: emerge
outsider: outsider
uploading: uploading
phase: phase
decrease: decrease
fear: fears fear
careful: careful
nutritionist: nutritionist nutritionists
permission: permissions permission
clean: clean cleans
wall: wall walls
climbing: climbing
construction: construction
laughter: laughter
region: regions region
screaming: screaming
geographic: geographic
introspection: introspection
caramel: caramel caramels
seeking: seeking
presta: presta
mov: mov
cancer: cancer
voluminous: voluminous
almond: almonds
capsular: capsular
mold: mold molds
intercourse: intercourse
popsicle: popsicles
dollar: dollars dollar
hypersensitivity: hypersensitivity
ahead: ahead
unneeded: unneeded
shell: shells
sedate: sedate
plumber: plumber
recommending: recommending
infesting: infesting
reflex: reflexes reflex
peroxide: peroxide
replenishing: replenishing
inclusion: inclusion
purchasing: purchasing
inhibit: inhibit
mulch: mulch
checked: checked
stand: stand stands
additive: additives
tightly: tightly
signal: signal signals
performance: performances performance
stationery: stationery
receipt: receipts receipt
unscrew: unscrew
script: script scripts
parent: parents parent
explorer: explorer
gather: gather
forearm: forearm forearms
alkalinity: alkalinity
bothering: bothering
riddled: riddled
expressing: expressing
twitter: twitter
itemize: itemize
incapable: incapable
monitoring: monitoring
cushion: cushion
advertisement: advertisement
beautiful: beautiful
imagine: imagine
unusual: unusual
hospital: hospital hospitals
undo: undo
bucket: buckets bucket
descend: descend
answering: answering
jr: jr
delineate: delineate
worry: worry worries
space: spaces space
hottest: hottest
deanne: deanne
woof: woof
contagious: contagious
arraignment: arraignments
plenty: plenty
chip: chips chip
jealous: jealous
residue: residue
violently: violently
office: office
disingenuous: disingenuous
breath: breath breaths
jointly: jointly
plywood: plywood
distribute: distribute
account: accounts account
project: projects project
sort: sort sorts
youtube: youtube
walnut: walnuts walnut
pertinent: pertinent
idea: idea ideas
change: change changes
nerve: nerve nerves
creates: creates
pflag: pflag
dwarf: dwarf
frass: frass
balloon: balloon
relationship: relationships relationship
habitat: habitat habitats
skeptical: skeptical
burrow: burrow
spending: spending
smoke: smoke
messy: messy
positioning: positioning
hundred: hundreds
liven: liven
constraint: constraints
mention: mention
credit: credit
herb: herbs herb
stating: stating
stance: stance
concerned: concerned
instance: instance
clogged: clogged
debris: debris
cutlet: cutlet cutlets
situate: situate
assist: assist
broadly: broadly
appeal: appeal
deduct: deduct
pain: pain
shattered: shattered
itemizing: itemizing
surf: surf
life: lives life
mist: mist
airway: airway
cartilage: cartilage
removal: removal
replicate: replicate
tub: tubs tub
ointment: ointment ointments
mean: mean means
mounting: mounting
experimenting: experimenting
vegetable: vegetables vegetable
divulged: divulged
particular: particular particulars
fertilize: fertilize
mango: mango
alone: alone
selenium: selenium
gorilla: gorilla
given: given
expressive: expressive
approval: approval
bloodborne: bloodborne
target: targets target
tighten: tighten
hump: humps
investigator: investigators investigator
prepare: prepare
dominate: dominate
conversational: conversational
acknowledged: acknowledged
mirror: mirrors mirror
considered: considered
touch: touch touches
orthotics: orthotics
short: short shorts
create: create
restless: restless
forever: forever
resource: resource resources
abscess: abscesses abscess
decor: decor
flip: flip
bulge: bulges bulge
suggests: suggests
system: systems system
lasagna: lasagna
bus: bus
fidget: fidget
swivel: swivels swivel
levied: levied
pediatric: pediatric
tender: tender
female: female females
recording: recording recordings
cavity: cavity
nauseating: nauseating
stim: stim
creasing: creasing
contaminated: contaminated
usable: usable
benefit: benefit benefits
urethra: urethra
ol: ol
swelling: swelling
meal: meal meals
noticing: noticing
emphasis: emphasis
continues: continues
insulin: insulin
telling: telling
doghouse: doghouse
unlikely: unlikely
miss: miss
reaching: reaching
supplementation: supplementation
reject: reject
stopwatch: stopwatch
fall: fall falls
hip: hips hip
chelate: chelates
slightly: slightly
cooler: cooler
curve: curve curves
unhappy: unhappy
win: wins win
exotics: exotics
acquaintance: acquaintance acquaintances
pronounced: pronounced
hasten: hasten
affair: affair affairs
relevance: relevance
multiplying: multiplying
cvt: cvt
helpful: helpful
rinsing: rinsing
leather: leather
soreness: soreness
cheating: cheating
tracheotomy: tracheotomy
thorn: thorn
membrane: membrane
blaming: blaming
pledge: pledge
certain: certain
sadly: sadly
streaming: streaming
woody: woody
revolution: revolution
bathing: bathing
find: find finds
explain: explain
telltale: telltale
purge: purge
conduction: conduction
frost: frost
bell: bell
disposable: disposable
redness: redness
tapering: tapering
librarian: librarian
bring: bring
align: align
track: track tracks
unhealthy: unhealthy
witness: witness
placement: placement
spritz: spritzes spritz
clip: clip clips
react: react
dripping: dripping
reptile: reptiles reptile
nozzle: nozzle
citing: citing
addition: additions addition
flame: flame
cariñosos: cariñosos
aired: aired
learn: learn
choose: choose
small: small
drinking: drinking
loaf: loaf
formed: formed
hamstring: hamstring
protects: protects
ever: ever
self: selves self
assortment: assortment
cocoa: cocoa
assume: assume
utis: utis
retort: retorts
down: downs
pluck: pluck
brother: brother
crisis: crisis
cloudy: cloudy
exposure: exposure
quarantine: quarantine
library: library libraries
station: station stations
organophosphate: organophosphates
rolling: rolling
animation: animation
urgent: urgent
avian: avian
timeline: timelines timeline
toe: toes toe
poisonous: poisonous
everyone: everyone
scrubber: scrubber
coating: coating
beginner: beginner beginners
flavored: flavored
economical: economical
podiatrist: podiatrist
attainable: attainable
three: three threes
gentle: gentle
indicated: indicated
whether: whether
getaway: getaway
opening: openings opening
cost: costs cost
soon: soon
machine: machine machines
child: child children
brake: brake brakes
camaraderie: camaraderie
representative: representatives representative
tennis: tennis
dropped: dropped
filled: filled
cottage: cottage
hopelessly: hopelessly
apps: apps
sea: sea
soap: soap soaps
qualified: qualified
pursuing: pursuing
puppy: puppy puppies
dried: dried
forex: forex
jagged: jagged
shaving: shavings
earlier: earlier
strap: straps strap
rising: rising
potluck: potluck
positivity: positivity
adjacent: adjacent
resolution: resolution
incorporated: incorporated
slow: slow
relax: relax
recruit: recruit recruits
corrosion: corrosion
wildly: wildly
blending: blending
colder: colder
undivided: undivided
humanitarian: humanitarian
brat: brat
abusive: abusive
indian: indian
alarm: alarm
rough: rough
medical: medical
sink: sink sinks
somers: somers
cleanser: cleansers cleanser
moreover: moreover
pack: pack
fur: fur
partial: partial
microsoft: microsoft
rescued: rescued
follicle: follicle follicles
marriage: marriage
volunteer: volunteers volunteer
f: f
tarde: tarde
organizing: organizing
reinfestation: reinfestation
attack: attack attacks
eyelash: eyelashes
tapeworm: tapeworm tapeworms
patient: patients patient
examination: examination
quilted: quilted
bye: bye
knob: knob
de: de
caused: caused
exhilarating: exhilarating
tensing: tensing
bowl: bowl bowls
whichever: whichever
maxing: maxing
recognized: recognized
helpguide: helpguide
dispatcher: dispatcher
limit: limit limits
alleviating: alleviating
salutation: salutations salutation
boiling: boiling
click: click
crocheted: crocheted
shoulder: shoulder shoulders
engage: engage
arrange: arrange
horizon: horizons
july: july
satisfy: satisfy
te: te
school: school
carpet: carpets
viewing: viewing
instant: instant
wing: wing wings
tablespoon: tablespoons tablespoon
inspired: inspired
academy: academy
real: real
sleeve: sleeves sleeve
lateralis: lateralis
enjoys: enjoys
related: related
engaged: engaged
crowd: crowd
node: nodes node
unavoidable: unavoidable
metaphor: metaphors
george: george
aloud: aloud
simply: simply
destination: destination
cause: cause causes
unglazed: unglazed
snip: snip
checkup: checkup checkups
prescription: prescription
darkened: darkened
verbal: verbal
product: products product
wife: wife
wind: wind winds
upright: upright
julia: julia
caliper: calipers
worried: worried
weather: weather
john: john
vice: vice
moved: moved
recipe: recipes recipe
coordinated: coordinated
lesion: lesions lesion
keeping: keeping
brushing: brushing
buffeting: buffeting
accommodate: accommodate
headache: headache
noun: noun
unique: unique
offering: offering
calorie: calorie calories
offer: offers offer
medlineplus: medlineplus
straightforward: straightforward
recite: recite
wooden: wooden
arsenic: arsenic
makeup: makeup
thoroughly: thoroughly
duration: durations duration
replacement: replacement
specify: specify
come: come comes
overhead: overhead
lash: lash
web: web
resistance: resistance
rabbit: rabbits rabbit
ache: aches
spade: spades
compliance: compliance
mate: mate
business: businesses business
using: using
gathering: gathering
exceeding: exceeding
powerpoint: powerpoint
sheath: sheath
intention: intentions intention
swan: swans
trusted: trusted
worthwhile: worthwhile
screwed: screwed
miter: miter
kurtz: kurtz
kbb: kbb
keep: keep keeps
fixing: fixing
cooped: cooped
manager: manager managers
certified: certified
stare: stares stare
chewy: chewy
depression: depression
blind: blinds
scalp: scalp
blackberry: blackberries
socialization: socialization
bleach: bleach
worsen: worsen
evaporating: evaporating
size: size sizes
completed: completed
unclipping: unclipping
thermostat: thermostat
bypass: bypass
unsound: unsound
sold: sold
reinstalled: reinstalled
mess: mess
eye: eye eyes
unfold: unfold
sidewalk: sidewalk
eventually: eventually
lipoma: lipomas lipoma
happen: happen
rotted: rotted
whenever: whenever
shaded: shaded
major: major
manufactured: manufactured
elemental: elemental
likewise: likewise
loveseat: loveseats
porridge: porridge
canada: canada
sanitize: sanitize
includes: includes
financial: financial
carbonated: carbonated
radius: radius
repeat: repeat
trained: trained
cigarette: cigarette
diverting: diverting
requires: requires
happy: happy
overpacking: overpacking
crutch: crutch
barn: barn
quart: quart
casserole: casserole casseroles
use: use
pit: pits
marinating: marinating
mood: mood
landing: landing
ultimately: ultimately
unresponsive: unresponsive
central: central
explaining: explaining
favor: favor favors
judge: judges judge
someone: someone
aloof: aloof
circumference: circumference
spends: spends
harvest: harvest
braced: braced
rb: rb
knowing: knowing
feisty: feisty
recognizing: recognizing
cheer: cheers cheer
requirement: requirements requirement
recognition: recognition
examined: examined
matter: matters matter
feces: feces
nap: nap
attitude: attitude
say: say says
extended: extended
coconut: coconut
beneficial: beneficial
scrape: scrapes scrape
deficient: deficient
raw: raw
something: something
delectable: delectable
friction: friction
bore: bore
stainless: stainless
resealed: resealed
grade: grades grade
roughening: roughening
strong: strong
otherwise: otherwise
view: view
nesting: nesting
shut: shut
simulate: simulate
precaution: precautions
flesh: flesh
cosmetic: cosmetics
avoid: avoid
seventy: seventy
specified: specified
accessible: accessible
restaurant: restaurant
fraying: fraying
prevention: prevention
spice: spice spices
lgbtq: lgbtq
condiment: condiments
indication: indication indications
douche: douches
husband: husband
father: father
le: less le les
raindrop: raindrops
implies: implies
sing: sing
point: point points
fill: fills fill
inbox: inbox
accurate: accurate
site: sites site
boyfriend: boyfriend
whistling: whistling
containing: containing
crush: crush
claim: claim claims
previous: previous
appears: appears
disinfect: disinfect
yield: yield
thorough: thorough
forgetting: forgetting
adopted: adopted
parenting: parenting
infection: infections infection
got: got
younger: younger
drastically: drastically
legible: legible
kindle: kindle
much: much
casual: casual
addiction: addiction addictions
wo: wo
comprehensive: comprehensive
choice: choices choice
storyline: storyline
vanilla: vanilla
stacking: stacking
turn: turn turns
fipronil: fipronil
calculation: calculation calculations
mario: mario
reheated: reheated
write: write
jersey: jersey
cyanosis: cyanosis
tidiest: tidiest
mindset: mindset
humanly: humanly
neck: neck
told: told
unexpectedly: unexpectedly
sneaker: sneakers
smiling: smiling
principal: principal
soldier: soldiers soldier
frying: frying
dmdboard: dmdboard
resuscitation: resuscitation
medication: medication medications
reacted: reacted
furnishing: furnishings
advantix: advantix
cleared: cleared
accused: accused
kept: kept
watch: watches watch
evaluating: evaluating
celsius: celsius
compassionate: compassionate
subtracted: subtracted
unbalanced: unbalanced
guzzle: guzzle
gender: gender
let: let lets
disconcert: disconcert
scent: scent
widest: widest
float: float
discontinue: discontinue
literally: literally
shaker: shakers
carp: carp
involves: involves
wander: wander
ny: ny
crash: crash
impairs: impairs
studying: studying
pro: pro pros
pura: pura
rehabbed: rehabbed
stubborn: stubborn
measure: measures measure
wasting: wasting
emoji: emoji
mental: mental
blanket: blankets blanket
fancy: fancy
fertilizer: fertilizer
munz: munz
exchange: exchanges exchange
exaggerated: exaggerated
long: long
genitals: genitals
rodent: rodent rodents
blunt: blunt
alteration: alterations
beverage: beverages beverage
old: olds old
evaluate: evaluate
atomic: atomic
irvine: irvine
carry: carries carry
seldom: seldom
greasing: greasing
skit: skit skits
flaw: flaws
pipe: pipes pipe
graze: graze
befriend: befriend
slab: slabs slab
baked: baked
itchiness: itchiness
suggestion: suggestion suggestions
countertop: countertops countertop
cursing: cursing
packaged: packaged
protein: protein proteins
posture: posture
elderly: elderly
released: released
fuel: fuel
formality: formality
roller: roller rollers
emerging: emerging
car: car cars
infrastructure: infrastructure
draw: draws draw
hygiene: hygiene
legume: legumes
eats: eats
tax: taxes tax
bigger: bigger
et: et
drape: drapes
seem: seem
particle: particles
table: tables table
playing: playing
strictly: strictly
networking: networking
arises: arises
sharing: sharing
actually: actually
nameless: nameless
afterward: afterward
besides: besides
remained: remained
brown: brown
kit: kits kit
rush: rush
refilling: refilling
salt: salt salts
dozen: dozens
happens: happens
asset: assets
demonstration: demonstration
teacher: teacher teachers
canners: canners
downtown: downtown
ptsd: ptsd
strawberry: strawberries
template: template
busy: busy
facing: facing
protected: protected
photo: photo photos
predator: predators
inch: inches inch
weakened: weakened
squash: squash
valuable: valuable
realizing: realizing
stabilize: stabilize
gas: gasses gas
alertness: alertness
dangerous: dangerous
guilty: guilty
sentence: sentence sentences
hygrometer: hygrometer
rototiller: rototiller
similarly: similarly
grab: grab
example: example examples
platform: platforms platform
reinventing: reinventing
official: official officials
tension: tension
marine: marine
formulated: formulated
phone: phone
plot: plot
condition: condition conditions
probably: probably
lid: lids lid
tutorial: tutorial tutorials
dislocated: dislocated
drilling: drilling
campfire: campfire
weed: weed weeds
method: methods method
difference: difference differences
issue: issue issues
microscopic: microscopic
decreased: decreased
stage: stages stage
entry: entry
nitenpyram: nitenpyram
parental: parental
soybean: soybeans
daunting: daunting
perspective: perspective perspectives
firm: firm firms
shelter: shelters shelter
behavioral: behavioral
hit: hits hit
fewest: fewest
neurotypicals: neurotypicals
closing: closings closing
charging: charging
evacuate: evacuate
leave: leave
ideally: ideally
catered: catered
pound: pounds pound
conduct: conduct
gradual: gradual
preventable: preventable
growth: growths growth
abroad: abroad
foreign: foreign
kid: kids kid
injection: injections injection
underside: underside
rubbed: rubbed
study: study studies
drainpipe: drainpipe
drapery: drapery
threshold: threshold
plump: plump
answer: answers answer
caught: caught
liter: liter liters
recent: recent
tangling: tangling
microwave: microwave
describing: describing
mountain: mountain
suggest: suggest
mask: mask
politely: politely
interrogate: interrogate
sealable: sealable
raise: raise
california: california
black: black
nine: nine
yellow: yellow
exceed: exceed
knock: knock
mother: mothers mother
amateur: amateur
technique: technique techniques
actor: actors
rye: rye
outdoor: outdoor
optimistic: optimistic
informed: informed
anecdote: anecdotes anecdote
wipe: wipes wipe
plus: plus
contributing: contributing
ebooks: ebooks
community: communities community
sprint: sprints sprint
reason: reason reasons
preferred: preferred
planned: planned
closed: closed
phrasing: phrasing
deplete: deplete
september: september
earl: earl
drained: drained
diminish: diminish
involuntary: involuntary
user: users user
slippery: slippery
debit: debit
dressed: dressed
oftentimes: oftentimes
lvt: lvt
transmit: transmit
restarting: restarting
labeled: labeled
veterinarian: veterinarian veterinarians
affordable: affordable
cariño: cariño
drop: drop drops
native: native
categorizing: categorizing
bake: bake
dysfunction: dysfunction
fillet: fillet
shading: shading
frame: frame frames
sheet: sheets sheet
custom: custom
extension: extension
pressing: pressing
consumer: consumers
deserve: deserve
antibiotic: antibiotics
honestly: honestly
see: sees see
appearing: appearing
relocate: relocate
fully: fully
transformational: transformational
painting: painting
k: k
flower: flower flowers
staying: staying
fresh: fresh
prevent: prevent
wild: wild
hyphen: hyphens
homemade: homemade
closet: closet closets
catch: catch
staff: staff
chair: chair chairs
clinton: clinton
live: live
drift: drifts
warn: warn
marketing: marketing
bought: bought
porterhouse: porterhouse
valenti: valenti
cheat: cheat
corel: corel
evening: evening
approximately: approximately
vacuum: vacuum
inventory: inventory
artistic: artistic
extract: extract
belly: belly
lest: lest
aspect: aspect aspects
circle: circle circles
digestive: digestive
conflate: conflate
clarified: clarified
liver: liver
coin: coins
contacting: contacting
asparagus: asparagus
skinny: skinny
roommate: roommate roommates
tell: tell tells
consonant: consonants
demonstrates: demonstrates
giardia: giardia
muñozvoice: muñozvoice
frustration: frustrations frustration
drank: drank
enclose: enclose
football: football
rationally: rationally
troy: troy
zipper: zipper
rooting: rooting
disease: diseases disease
plaque: plaque
ya: ya
dijon: dijon
cagemates: cagemates
prescribed: prescribed
defibrillator: defibrillator
collaborate: collaborate
favorable: favorable
doc: docs
union: union
struggle: struggles struggle
sale: sale sales
bacterium: bacterium
aspiration: aspiration
wreak: wreak
chemotherapy: chemotherapy
dismount: dismount
peanut: peanuts peanut
grocery: grocery
trackpad: trackpad
costume: costume
accelerated: accelerated
dinotefuran: dinotefuran
discount: discount
speech: speeches speech
radio: radio
somewhat: somewhat
grove: groves
broom: broom
drive: drive
photograph: photographs
energy: energy
rhythm: rhythms rhythm
sanitized: sanitized
individual: individual individuals
sphere: spheres
fluke: flukes
satanic: satanic
suspicious: suspicious
hartcourt: hartcourt
sticky: sticky
dengue: dengue
vendor: vendor vendors
specie: species
suckles: suckles
filter: filters filter
strengthen: strengthen
brow: brow
soothe: soothe
looking: looking
filler: filler
matted: matted
interference: interference
federal: federal
designate: designate
dampening: dampening
hercules: hercules
remove: remove
hug: hugs hug
preservative: preservatives
observing: observing
connects: connects
metal: metals metal
condescending: condescending
crate: crates crate
decision: decision decisions
gameplay: gameplay
ft: ft
genital: genital
boundary: boundaries
close: closes close
waterproofer: waterproofer
brick: brick
unfriending: unfriending
spruce: spruce
feeling: feeling feelings
climate: climate climates
utilman: utilman
silence: silence
ex: ex exes
displacement: displacement
last: last lasts
offender: offender
cyst: cyst cysts
watchful: watchful
flour: flour
inquire: inquire
baby: baby
overabundance: overabundance
plain: plain
vitamin: vitamin vitamins
symbol: symbol
venom: venom
pose: poses pose
responsibility: responsibilities responsibility
sahara: sahara
appeared: appeared
fraction: fraction
twitch: twitch
communication: communication
detail: detail details
briefer: briefer
imported: imported
wrapping: wrapping
twitching: twitching
ignore: ignore
counterclockwise: counterclockwise
artist: artists artist
server: servers
pie: pie
tablet: tablet tablets
bittersweet: bittersweet
try: tries try
stored: stored
convenient: convenient
crime: crimes crime
stoop: stoop
fashioning: fashioning
digest: digest
orderly: orderly
despedida: despedida
gardening: gardening
window: window windows
quad: quads
spelled: spelled
bed: bed beds
roaming: roaming
seen: seen
poor: poor
dvd: dvd
patrick: patrick
hold: holds hold
forehead: forehead
initiate: initiate
garnish: garnish
face: face faces
resistant: resistant
minimal: minimal
amazing: amazing
overtaking: overtaking
soiled: soiled
retractable: retractable
overhang: overhangs overhang
entire: entire
unnoticed: unnoticed
brighten: brighten
rounded: rounded
department: department
dolan: dolan
aphid: aphids
creative: creative
accessory: accessories
charitable: charitable
groupon: groupon
toughness: toughness
rethink: rethink
blockage: blockages
hotdog: hotdogs
withdrawn: withdrawn
wavering: wavering
tarp: tarp
unwell: unwell
jute: jute
chili: chili
north: north
lifting: lifting
county: county
capanelliplant: capanelliplant
praise: praise
infrequently: infrequently
concentrating: concentrating
poster: poster posters
ruining: ruining
arial: arial
thicker: thicker
bladder: bladder
ecosystem: ecosystem
ah: ah
sliced: sliced
blinking: blinking
conversation: conversation conversations
installed: installed
releasing: releasing
rock: rocks rock
flexible: flexible
retrieved: retrieved
infectious: infectious
jawline: jawline
immune: immune
criticizes: criticizes
rhetoric: rhetoric
grabbing: grabbing
usage: usage
leg: leg legs
safest: safest
compress: compress compresses
code: code
chart: chart
rinsed: rinsed
braid: braid
demonstrate: demonstrate
hardy: hardy
gushing: gushing
access: access
observation: observation
wanted: wanted
ended: ended
taller: taller
flatten: flatten
nudge: nudge
overheat: overheat
recreation: recreation
grasp: grasp
doorway: doorways doorway
subscript: subscripts subscript
savory: savory
estimate: estimate estimates
blister: blisters
jacket: jacket
reassure: reassure
processed: processed
encouraging: encouraging
moisturizing: moisturizing
aac: aac
talking: talking
combative: combative
pretzel: pretzels
sugary: sugary
swim: swim
considerably: considerably
unsuccessful: unsuccessful
stripe: stripe
unknown: unknown
applies: applies
choking: choking
theatrical: theatrical
husbandry: husbandry
logic: logic
napkin: napkin
abrazos: abrazos
tagged: tagged
dog: dog dogs
precisely: precisely
vomit: vomit
run: runs run
patiently: patiently
nodding: nodding
subsequent: subsequent
ginseng: ginseng
result: results result
impression: impressions impression
puzzle: puzzles
aesthetic: aesthetics
giving: giving
impartial: impartial
regulate: regulate
south: south
peering: peering
packaging: packaging
surprise: surprises surprise
transport: transport
cord: cords
fahrenheit: fahrenheit
cared: cared
depleting: depleting
penalty: penalty
measured: measured
restarted: restarted
sulfate: sulfate sulfates
pirate: pirate
importantly: importantly
temptation: temptation temptations
charity: charity charities
heating: heating
basis: basis
chest: chest
crop: crop
iu: iu
kiss: kiss kisses
clear: clears clear
cockroach: cockroaches
studio: studio
worn: worn
leftover: leftover leftovers
collegial: collegial
anh: anh
kale: kale
bunch: bunch
dance: dance
communicating: communicating
complies: complies
knee: knee knees
combed: combed
combined: combined
pronto: pronto
plumper: plumper
powerless: powerless
originally: originally
lover: lover
inhumane: inhumane
leveler: leveler
abnormally: abnormally
insightful: insightful
qsart: qsart
fat: fat fats
dose: dose
historical: historical
la: la
strongest: strongest
unsubscribe: unsubscribe
certification: certification
dvm: dvm
folder: folder folders
reduce: reduce
pronounce: pronounce
christina: christina
coordination: coordination
map: maps map
gallery: gallery
vaccination: vaccination
wedging: wedging
farewell: farewell
argumentative: argumentative
overlap: overlaps overlap
italic: italics
pvc: pvc
overwatering: overwatering
compared: compared
reliable: reliable
mentioning: mentioning
exacerbated: exacerbated
italian: italian
express: express expresses
handling: handling
dehydrates: dehydrates
emphasize: emphasize
qualification: qualifications
lamest: lamest
nearly: nearly
refrigerated: refrigerated
turf: turf
foam: foam
maintaining: maintaining
governing: governing
disclose: disclose
horizontal: horizontal
qigong: qigong
solo: solo
importation: importation
bump: bump bumps
accidentally: accidentally
selects: selects
crystallizing: crystallizing
mantis: mantises mantis
done: done
scratching: scratching
proportionate: proportionate
joes: joes
winter: winters winter
roundabout: roundabout
donation: donation donations
reseal: reseal
supplemental: supplemental
hobby: hobbies hobby
dense: dense
syllabus: syllabus
acquiring: acquiring
capillary: capillaries
shouting: shouting
never: never
therapist: therapists therapist
yellowish: yellowish
layout: layout
communicated: communicated
valid: valid
ymca: ymca
clumsy: clumsy
pave: pave
familiarizing: familiarizing
preparing: preparing
luther: luther
limiting: limiting
improves: improves
restore: restore
chromatophores: chromatophores
refrigerate: refrigerate
forking: forking
daron: daron
inhale: inhale
butler: butler
emulate: emulate
pearled: pearled
lewis: lewis
metalworking: metalworking
submerge: submerge
counselling: counselling
delete: delete
selamectin: selamectin
vocal: vocals
handlebar: handlebars
diphtheria: diphtheria
alternately: alternately
sensitive: sensitive
added: added
worked: worked
paranoid: paranoid
room: room rooms
sucking: sucking
triathlete: triathlete
cast: cast
enters: enters
proud: proud
troublemaker: troublemaker troublemakers
spotless: spotless
reacts: reacts
regimen: regimen
sudden: sudden
acre: acre
runnier: runnier
prenatal: prenatal
tire: tire tires
regardless: regardless
consume: consume
fertilized: fertilized
kevin: kevin
margin: margin
dining: dining
dusting: dusting
groin: groin
bee: bees
dietary: dietary
permethrine: permethrine
escape: escapes escape
mentioned: mentioned
loneliness: loneliness
guess: guess
pretty: pretty
thawed: thawed
dynamic: dynamic
victim: victim
assessment: assessment
kind: kinds kind
confidence: confidence
data: data
trace: traces trace
enclosure: enclosure
sr: sr
carbonate: carbonate
weatherproofing: weatherproofing
cage: cage cages
model: model models
forum: forum forums
pregnancy: pregnancy
topping: toppings topping
fiber: fibers fiber
evidence: evidence
caramelization: caramelization
anesthetize: anesthetize
correct: correct
emotionally: emotionally
inherent: inherent
padded: padded
untainted: untainted
motion: motions motion
retail: retail
environmental: environmental
basic: basics basic
warned: warned
soy: soy
house: houses house
passivity: passivity
act: act acts
trap: trap traps
tetra: tetras tetra
pulse: pulse
drawer: drawers drawer
shampoo: shampoos shampoo
late: late
brushed: brushed
discipline: discipline disciplines
outside: outside outsides
weak: weak
platonic: platonic
assuming: assuming
tangle: tangle tangles
lubricated: lubricated
competent: competent
groggy: groggy
legitimate: legitimate
stemming: stemming
stimulating: stimulating
poke: poke
pressured: pressured
trimming: trimming
mostly: mostly
spoken: spoken
dislike: dislike dislikes
punishing: punishing
uncomfortable: uncomfortable
musical: musical
redirect: redirect
closest: closest
foul: foul
nz: nz
finally: finally
fish: fishes fish
pulling: pulling
denture: denture dentures
could: could
equally: equally
consideration: consideration
jostled: jostled
abundance: abundance
desire: desire
unplugging: unplugging
supportive: supportive
reapply: reapply
safe: safe
tiny: tiny
immensely: immensely
scuff: scuff
odor: odor odors
watering: watering
constructing: constructing
tuition: tuition
disc: disc
thermometer: thermometer
seedling: seedling seedlings
right: rights right
thanks: thanks
unfriendliness: unfriendliness
concealer: concealer
fluridone: fluridone
torn: torn
moderate: moderate
describe: describe
disconnecting: disconnecting
inability: inability
excitement: excitement
recreational: recreational
classmate: classmate classmates
toward: toward
extend: extend
spelling: spelling
promise: promises promise
acceptance: acceptance
service: service services
sustainably: sustainably
affirming: affirming
jostle: jostle
wiping: wiping
directory: directory
allowance: allowance
film: film films
psychiatric: psychiatric
staple: staple staples
beside: beside
profile: profile
near: near
fda: fda
trembling: trembling
pilonidal: pilonidal
fault: fault
ashley: ashley
borrow: borrow
focusing: focusing
precision: precision
swiftly: swiftly
politics: politics
address: addresses address
remarketing: remarketing
shallow: shallow
invade: invade
reassuring: reassuring
jeweler: jeweler jewelers
movement: movements movement
grainy: grainy
paragraph: paragraphs paragraph
men: men
gray: gray
pippa: pippa
look: looks look
flavor: flavors flavor
pawlisch: pawlisch
refer: refer
horticultural: horticultural
top: top tops
escalator: escalator
interactive: interactive
molecular: molecular
decorate: decorate
draft: draft
vasopressin: vasopressin
assignment: assignment assignments
greener: greener
converted: converted
neonicotinoids: neonicotinoids
innovation: innovation
spit: spit
awake: awake
march: march
squeegee: squeegee
row: row rows
nonverbal: nonverbal
ranging: ranging
flight: flight
incident: incidents incident
applied: applied
multiplied: multiplied
encounter: encounters encounter
gradually: gradually
sheltered: sheltered
anvil: anvil
pinched: pinched
hitting: hitting
avoided: avoided
basing: basing
grieving: grieving
original: original
misbehaving: misbehaving
maneuver: maneuvers maneuver
noir: noir
graveside: graveside
bicycle: bicycle
lifetime: lifetime lifetimes
think: think
cue: cues
intentionally: intentionally
correction: correction corrections
gymnastics: gymnastics
coleslaw: coleslaw
radical: radical
earplug: earplugs
section: section sections
container: containers container
pricier: pricier
paycheck: paycheck
soya: soya
channellocks: channellocks
taken: taken
insult: insult
softened: softened
anus: anus
varied: varied
plant: plant plants
rotation: rotation rotations
understand: understand
calf: calf calves
allowed: allowed
bubble: bubble
rewritten: rewritten
papaya: papaya
occurrence: occurrence
train: train trains
simplicity: simplicity
apologizing: apologizing
lead: leads lead
prompting: prompting
expansive: expansive
edits: edits
fix: fixes fix
op: op
cannibalistic: cannibalistic
stephanie: stephanie
condenses: condenses
lazy: lazy
onto: onto
batch: batches
instructive: instructive
console: console
embarrassed: embarrassed
charged: charged
hangout: hangout
listed: listed
shutting: shutting
essence: essences essence
minimum: minimum
más: más
hello: hello
mesh: mesh
broken: broken
stroking: stroking
acronym: acronym
turning: turning
japan: japan
aligned: aligned
subway: subway
often: often
faxing: faxing
investigation: investigation investigations
puberty: puberty
splash: splash
hurry: hurry
gummy: gummy
okra: okra
rip: rip
pc: pc
resist: resist
mail: mail
transparency: transparency
instrument: instrument
deeply: deeply
invasive: invasive
contrary: contrary
guard: guard
infecting: infecting
diatomaceous: diatomaceous
missed: missed
hour: hours hour
wardrobe: wardrobes
subsequently: subsequently
tray: tray trays
waxed: waxed
roach: roaches roach
coworker: coworker
hiring: hiring
overcooked: overcooked
type: types type
history: history histories
breeze: breezes breeze
smelly: smelly
portfolio: portfolio
herbal: herbal
uncheck: uncheck
wash: wash
outline: outline
due: due
rely: rely
dept: dept
overwhelmingly: overwhelmingly
usb: usb
firefox: firefox
proceeds: proceeds
additional: additional
entirety: entirety
concerted: concerted
microflora: microflora
routine: routine
vacant: vacant
typing: typing
pellet: pellets
tailpipe: tailpipe
ought: ought
therefore: therefore
defrost: defrost
adiós: adiós
cacao: cacao
sweden: sweden
dorsal: dorsal
hearing: hearing hearings
autistic: autistic
smartphone: smartphone
lower: lower
alert: alerts alert
bunched: bunched
indirect: indirect
newbie: newbie
cooled: cooled
extra: extra
ppt: ppt
habit: habit habits
howard: howard
fed: fed
created: created
collard: collards
global: global
chem: chem
inundate: inundate
steamy: steamy
expire: expire
punch: punch
unplug: unplug
notification: notification
settling: settling
anytime: anytime
pa: pa
variant: variants
distort: distort
summer: summer
unassuming: unassuming
hoard: hoard
possibly: possibly
knitted: knitted
consumption: consumption
powerful: powerful
blaberus: blaberus
cooky: cookies
curved: curved
tough: tough
sore: sore
mifflin: mifflin
adequately: adequately
happiness: happiness
league: league
take: takes take
settlement: settlement
allergy: allergies allergy
lethargic: lethargic
gibson: gibson
copy: copies copy
fling: fling
teaching: teaching
emojis: emojis
bind: bind
volunteering: volunteering
haircut: haircut
married: married
difficulty: difficulties difficulty
io: ios
defines: defines
recently: recently
displacing: displacing
avenue: avenue
recommended: recommended
jelly: jelly
lego: legos
nearest: nearest
appear: appear
also: also
gallon: gallons gallon
cognizant: cognizant
beginning: beginning
pet: pets pet
cloud: clouds
feedback: feedback
kidnapped: kidnapped
agent: agents agent
copied: copied
navigating: navigating
install: install
hardier: hardier
loyalty: loyalties
tip: tips tip
reflects: reflects
multiple: multiple
trauma: trauma
stranger: strangers stranger
balance: balance
expression: expression expressions
delivering: delivering
captivity: captivity
whipping: whipping
wiggle: wiggle
mailing: mailing
regretted: regretted
braise: braise
peer: peer peers
dry: dry dries
ladder: ladder
seresto: seresto
marked: marked
collarbone: collarbone
lcsw: lcsw
nonetheless: nonetheless
scary: scary
horticulturist: horticulturist
buen: buen
wiper: wipers wiper
core: core
bout: bout
privacy: privacy
depressed: depressed
boxrec: boxrec
expectation: expectations
scalpel: scalpel
dragging: dragging
printed: printed
exploring: exploring
entrance: entrance
redden: redden
rectangular: rectangular
salted: salted
cupramine: cupramine
held: held
neurological: neurological
pointed: pointed
fine: fine
vocabulary: vocabulary
dryer: dryer
natural: natural
cake: cakes cake
submerged: submerged
cock: cock
flavonoid: flavonoids
fork: forks fork
slap: slap
paintbrush: paintbrush
tidy: tidy
podcasts: podcasts
brings: brings
dalloway: dalloway
diagnosis: diagnosis
alternatively: alternatively
supporting: supporting
gone: gone
apache: apache
lighter: lighters lighter
messing: messing
lined: lined
source: sources source
animated: animated
draining: draining
fight: fight fights
amur: amur
lightheadedness: lightheadedness
literal: literal
excuse: excuses excuse
mechanic: mechanic
thrive: thrive
respectively: respectively
buildup: buildup
pitcher: pitcher pitchers
warming: warming
threaten: threaten
safeguard: safeguard
needy: needy
front: fronts front
memory: memory memories
overly: overly
promising: promising
preemie: preemies preemie
tilting: tilting
rinse: rinse
adapt: adapt
legal: legal
boiled: boiled
chore: chore
equipment: equipment
body: body bodies
damp: damp
build: builds build
finding: finding
pertaining: pertaining
pile: pile piles
momentum: momentum
cracker: cracker crackers
american: american americans
must: must
sport: sport sports
population: populations
insomnia: insomnia
stability: stability
lemon: lemon
unhook: unhook
diameter: diameter
vaccinated: vaccinated
cat: cats cat
speaks: speaks
four: fours four
viewer: viewer viewers
extending: extending
alcoholic: alcoholic alcoholics
believing: believing
humidity: humidity
cautious: cautious
preserve: preserve
fatal: fatal
capitalism: capitalism
interfere: interfere
moral: morals
aerobic: aerobic
tumor: tumors tumor
race: race races
play: play plays
increase: increase increases
bacteria: bacteria
diabetic: diabetics
gravity: gravity
manga: manga
gift: gift gifts
resetting: resetting
traded: traded
forceful: forceful
oven: oven
subdued: subdued
micromanagement: micromanagement
jonesmaster: jonesmaster
assault: assault
opinion: opinions opinion
excessively: excessively
wellness: wellness
reconnaissance: reconnaissance
echolalia: echolalia
reference: reference references
shed: shed
seize: seize
specialize: specialize
male: male males
un: un
thursday: thursday
dad: dad
alcoholism: alcoholism
personnel: personnel
abuse: abuse
developmental: developmental
efas: efas
honey: honey
bitten: bitten
violate: violate
entertaining: entertaining
faith: faith
website: websites website
uneasy: uneasy
monkey: monkey
threat: threats
mindful: mindful
add: adds add
lighting: lighting
gcf: gcf
yummy: yummy
hose: hose
extinguisher: extinguisher
sucked: sucked
talk: talk
daily: daily
transpires: transpires
fitted: fitted
propane: propane
valued: valued
manganese: manganese
distract: distract
popular: popular
extortionate: extortionate
deliver: deliver
disrespectful: disrespectful
capability: capabilities capability
developing: developing
nook: nooks
frequents: frequents
nursing: nursing
updated: updated
deck: deck
diaphragm: diaphragm
rot: rot
softer: softer
dosing: dosing
proactive: proactive
nutritious: nutritious
diquat: diquat
predictable: predictable
judging: judging
later: later
communicates: communicates
gear: gears gear
meant: meant
common: common
neutering: neutering
spoke: spokes spoke
groomers: groomers
sunny: sunny
cavy: cavies cavy
glyphosate: glyphosate
atm: atm atms
trouble: troubles trouble
pharmacy: pharmacy pharmacies
spinosad: spinosad
king: kings king
pocket: pocket pockets
explode: explode
distracted: distracted
accomplish: accomplish
putting: putting
energizing: energizing
enzymatic: enzymatic
song: song songs
powdery: powdery
square: square squares
wetsuit: wetsuit
fragment: fragments
swamp: swamp
conflict: conflict conflicts
floorboard: floorboards
thus: thus
effectiveness: effectiveness
resale: resale
overstimulation: overstimulation
replace: replace
decayed: decayed
germ: germs
dare: dares
criticize: criticize
weakest: weakest
imaginary: imaginary
topper: toppers
died: died
teach: teaches teach
record: records record
choppy: choppy
relative: relative relatives
oregano: oregano
pecs: pecs
keywords: keywords
oversleeping: oversleeping
surgeon: surgeon
element: element elements
practical: practical
lap: lap
divide: divide
trial: trial
united: united
shaft: shaft
broadband: broadband
spot: spots spot
meta: meta
hunching: hunching
diced: diced
inspecting: inspecting
stay: stays stay
tantrum: tantrums
creaking: creaking
support: supports support
longer: longer
avi: avi
box: box boxes
houghton: houghton
macbook: macbook
rpm: rpm
dissatisfied: dissatisfied
spent: spent
omnivorous: omnivorous
detached: detached
really: really
prisoner: prisoners
virtually: virtually
temperament: temperament
arbor: arbor
diagram: diagram
homework: homework
relies: relies
installation: installation
lotion: lotion
played: played
triangle: triangle triangles
beef: beef
curry: curries
expand: expand
thigh: thighs thigh
lymph: lymph
client: clients client
great: great
degree: degrees degree
frozen: frozen
shaking: shaking
spin: spin spins
submit: submit
lease: lease
approaching: approaching
actively: actively
term: terms term
wand: wand
accurately: accurately
pinch: pinches pinch
conspicuously: conspicuously
heading: heading
sorority: sororities
motivate: motivate
braising: braising
decided: decided
vulnerability: vulnerability
fluent: fluent
investing: investing
sophistication: sophistication
breakfast: breakfast
educating: educating
pic: pics
counseling: counseling
bedroom: bedroom
lamp: lamp
writing: writings writing
intense: intense
drunken: drunken
cracked: cracked
pooling: pooling
nylon: nylon
insincere: insincere
true: true
remarkable: remarkable
shade: shade shades
snap: snaps snap
afghanistan: afghanistan
b: b
clothes: clothes
zulfiger: zulfiger
greet: greet
generating: generating
stroke: strokes stroke
prescribe: prescribe
refined: refined
ingesting: ingesting
soup: soup soups
disposed: disposed
spinning: spinning
assistant: assistant
detention: detention
sorry: sorry
notepad: notepad
deleted: deleted
lovely: lovely
word: word words
afternoon: afternoon
explosion: explosions explosion
totalling: totalling
concealing: concealing
lettering: lettering
steadying: steadying
dunk: dunk
hide: hide
engagement: engagement
mock: mock
participant: participants
knew: knew
macaw: macaws macaw
sulfur: sulfur
highlighted: highlighted
weight: weights weight
seller: sellers seller
blend: blend
streak: streaks
fit: fit fits
resemble: resemble
comparison: comparison
distinct: distinct
longest: longest
require: require
twirl: twirl
padding: padding
enforcing: enforcing
shortest: shortest
dashing: dashing
serf: serves
protruding: protruding
reward: reward rewards
prop: props
copper: copper
estimating: estimating
poised: poised
kickstart: kickstart
dermatologist: dermatologists dermatologist
scope: scope
wet: wet
axle: axle
researcher: researchers
cholera: cholera
majority: majority
veterinary: veterinary
pricing: pricing
scrubbing: scrubbing
granule: granules
shelled: shelled
appraiser: appraiser
crafting: crafting
stopping: stopping
pen: pens pen
forming: forming
soundcloud: soundcloud
span: span
voice: voice
bedtime: bedtime
dating: dating
aspirin: aspirin
bulk: bulk
wobbly: wobbly
independence: independence
larva: larvae
happily: happily
allowing: allowing
dishcloth: dishcloth
magenta: magenta
finished: finished
crystal: crystals crystal
refusing: refusing
organic: organic
familiar: familiar
syringe: syringe
fulfill: fulfill
professional: professional professionals
picky: picky
several: several
expense: expenses
tradition: tradition
triathlon: triathlon
cardiopulmonary: cardiopulmonary
pandemic: pandemic
high: high
paying: paying
facility: facilities facility
affectionately: affectionately
bookshelf: bookshelves
us: uses
asshole: asshole
spirit: spirits
recovery: recovery
nutrition: nutrition
zombie: zombies zombie
nicely: nicely
lance: lance
seriously: seriously
soften: soften
serving: serving
receptor: receptors
update: updates update
pretending: pretending
tweaked: tweaked
responsiveness: responsiveness
cucumber: cucumber
larynx: larynx
emergent: emergent
ally: allies
cultivate: cultivate
rehabilitation: rehabilitation
congregate: congregate
rubber: rubber
san: san
exercising: exercising
meditate: meditate
compliment: compliments compliment
suited: suited
seaweed: seaweed
approved: approved
export: export
snake: snake
speak: speak
required: required
proceed: proceed
toweling: toweling
absolutely: absolutely
mechanical: mechanical
mainly: mainly
passive: passive
butcher: butcher
adverse: adverse
discredited: discredited
r: r
wording: wording
designates: designates
tomorrow: tomorrow
tent: tents
dysentery: dysentery
church: churches
fleece: fleece
attend: attend
seeing: seeing
contextual: contextual
tested: tested
identifying: identifying
white: white
olympic: olympic
skip: skip
pregnant: pregnant
storing: storing
hierarchy: hierarchy
testing: testing
coat: coat
proven: proven
envision: envision
adjust: adjust
occasional: occasional
appetite: appetite
cab: cab
bacterial: bacterial
conceal: conceal
estimated: estimated
mission: missions mission
per: per
widespread: widespread
plugged: plugged
instantly: instantly
cited: cited
overburdening: overburdening
hired: hired
triple: triples triple
confines: confines
called: called
lowered: lowered
calmly: calmly
save: save
contribution: contribution
emotional: emotional
responds: responds
maximize: maximize
fibre: fibres fibre
sits: sits
broiler: broiler
spleen: spleen
formally: formally
sterilizes: sterilizes
used: used
locked: locked
establishing: establishing
friendly: friendly
swipe: swipe
teenager: teenagers teenager
compressing: compressing
neighbor: neighbor
bone: bone bones
illustrated: illustrated
assumption: assumption
washer: washer
student: students student
molting: molting
babysits: babysits
squeezing: squeezing
large: large
coalition: coalition
wiggling: wiggling
august: august
downloading: downloading
centered: centered
chosen: chosen
spoil: spoil
brass: brass
adapter: adapter
euthanize: euthanize
paved: paved
vessel: vessel vessels
refers: refers
absorbing: absorbing
showing: showing
sand: sand
december: december
framing: framing
substrate: substrates substrate
slope: slope
popularity: popularity
kitten: kittens kitten
ton: tons
hydrogen: hydrogen
mouse: mouse
applaud: applaud
weigh: weigh
progress: progress progresses
talked: talked
penetrates: penetrates
nlpmatchmaker: nlpmatchmaker
tingling: tingling
diseased: diseased
atmosphere: atmosphere
permanently: permanently
environment: environments environment
many: many
surgery: surgery
introduce: introduce
pineapple: pineapple
shoot: shoot shoots
rate: rate rates
audible: audible
tick: ticks
elimination: elimination
fallen: fallen
monitor: monitor
hashtag: hashtag
bird: bird birds
seating: seating
kazuhira: kazuhira
purchaser: purchaser
zelda: zelda
format: format formats
gum: gums gum
conditioner: conditioner conditioners
australia: australia
british: british
neonatal: neonatal
persistent: persistent
interfering: interfering
redo: redo
giblet: giblets
vulva: vulva
despedirse: despedirse
thumb: thumb thumbs
polite: polite
spotty: spotty
agreement: agreement
biography: biographies
lessen: lessen
redirecting: redirecting
freshwater: freshwater
providing: providing
heavy: heavy
harvesting: harvesting
unlike: unlike
incompatible: incompatible
priority: priority priorities
carbohydrate: carbohydrates
relates: relates
cliffhanger: cliffhanger
crew: crews
besos: besos
typo: typos
clarify: clarify
layover: layover
occur: occur
situation: situations situation
comfort: comfort
composed: composed
patience: patience
reverse: reverse
deglazing: deglazing
bookmark: bookmark
oily: oily
wine: wine
remind: remind
notebook: notebook
immature: immature
carnitine: carnitine
relay: relay relays
breakup: breakup
explore: explore
regulated: regulated
swimming: swimming
decoration: decorations
blamed: blamed
prior: prior
card: cards card
possession: possession
oto: otos
resort: resort
mindfulness: mindfulness
index: index
laid: laid
backing: backing
haloperidol: haloperidol
saw: saws saw
counteract: counteract
contribute: contribute
substitute: substitutes
blessing: blessing
dunlop: dunlop
accomplishment: accomplishments accomplishment
humid: humid
pushup: pushup
fungus: fungus
upside: upside
refuse: refuses
tighter: tighter
determinate: determinate
sight: sight
pair: pair
butter: butter butters
quickly: quickly
inform: inform
clearing: clearing
external: external
pizza: pizza pizzas
achievement: achievement
inner: inner
petersarchitecture: petersarchitecture
methodology: methodology
company: companies company
expiration: expiration
measurement: measurement measurements
cap: caps cap
tainted: tainted
scenic: scenic
withholding: withholding
cervical: cervical
sponsor: sponsors sponsor
actual: actual
academic: academic
oral: oral
pup: pup
diaper: diapers diaper
inclement: inclement
imagination: imagination
engages: engages
name: name names
general: general
normally: normally
environmentally: environmentally
chlorine: chlorine
cutscenes: cutscenes
stimulus: stimuli
fastening: fastening
mixer: mixer
resulting: resulting
uneven: uneven
egg: eggs egg
trash: trash
newspaper: newspaper newspapers
tour: tour
tactic: tactics
bedding: bedding
pace: pace
adrift: adrift
rectangle: rectangle
beta: beta
perfect: perfect
icon: icon icons
oversteps: oversteps
vampire: vampires
determined: determined
teacup: teacups
slowest: slowest
reoccurring: reoccurring
reduction: reduction
past: past
generally: generally
nip: nip
borrowed: borrowed
storyteller: storyteller
warmed: warmed
rim: rim
boot: boot
adam: adam
remainder: remainder
wireless: wireless
advocate: advocate
indicative: indicative
hobbyist: hobbyist
dusty: dusty
drawing: drawings drawing
toothbrush: toothbrush
stylize: stylize
lumbering: lumbering
massage: massage
humidify: humidify
jury: jury
ending: ending endings
poking: poking
oatmeal: oatmeal
random: random
nib: nibs
falling: falling
worship: worship
dump: dump
staphylococcus: staphylococcus
jones: jones
donut: donut
reporting: reporting
afecto: afecto
allergic: allergic
superman: superman
darker: darker
woman: woman women
extends: extends
vapor: vapor
budge: budge
wonderful: wonderful
adjustment: adjustments adjustment
nearer: nearer
preservation: preservation
excess: excess
gbp: gbp
humanity: humanity
harden: harden
severe: severe
reserve: reserve
knocking: knocking
comb: combs comb
important: important
lesson: lesson lessons
abdominal: abdominal
else: else
segment: segment
breastbone: breastbone
retreat: retreat
timed: timed
picking: picking
lunchables: lunchables
markup: markup
sawhorse: sawhorses sawhorse
though: though
bloody: bloody
brittle: brittle
complaint: complaint
graham: graham
built: built
divert: divert
jogging: jogging
friel: friel
back: backs back
screwing: screwing
generous: generous
age: ages age
substance: substance substances
firsthand: firsthand
mass: mass
showcase: showcase
bite: bite
curse: curse
presidential: presidential
squat: squats
twine: twine
gesticulate: gesticulate
wetting: wetting
stone: stones stone
cornstarch: cornstarch
insist: insist
missing: missing
preserving: preserving
garage: garages
noches: noches
poem: poems
heimlich: heimlich
autonomous: autonomous
soaked: soaked
analgesic: analgesics
harmful: harmful
road: roads road
overfeed: overfeed
precede: precede
fatter: fatter
older: older
designated: designated
canadian: canadian
succession: succession
bos: boss
downhill: downhill
kindness: kindness
inward: inward
blog: blog
stuffed: stuffed
ocean: ocean
reimburse: reimburse
drawback: drawbacks
ironman: ironman
razor: razor
cuss: cuss
blood: blood
griffin: griffin
downloadable: downloadable
u: u us
culprit: culprit
stem: stem stems
expiring: expiring
hurting: hurting
susceptible: susceptible
ryan: ryan
flavorful: flavorful
struck: struck
nipple: nipple
scrap: scraps scrap
chipping: chipping
reshaping: reshaping
na: na
noted: noted
cheeseburger: cheeseburgers
troubleshooting: troubleshooting
munch: munch
furniture: furniture
tastebud: tastebud
dislodge: dislodge
flightless: flightless
arterial: arterial
syrup: syrup
enjoy: enjoy
rail: rail
fungal: fungal
ok: ok
erratic: erratic
malfunction: malfunction
simplex: simplex
uploader: uploader
circumstance: circumstances
christmas: christmas
discolored: discolored
companion: companion
agitated: agitated
rattle: rattle
secretary: secretary
wolf: wolves
gb: gb
brave: brave
grass: grasses grass
mainstreaming: mainstreaming
eliminate: eliminate
poorer: poorer
standalone: standalone
sake: sake
castle: castles
favourite: favourite
fence: fence
surroundings: surroundings
slug: slugs slug
entering: entering
industry: industry
spotted: spotted
scale: scale scales
tightened: tightened
cleanliness: cleanliness
enhanced: enhanced
disappears: disappears
microgram: micrograms
specializes: specializes
adult: adult adults
plier: pliers
prep: prep
coping: coping
glucose: glucose
username: username
profit: profits
potential: potential
tran: tran
afterthought: afterthought
psychological: psychological
impatient: impatient
gauze: gauze
sized: sized
delaying: delaying
waxy: waxy
silk: silk
lyme: lyme
tuna: tuna
nearby: nearby
portrayal: portrayal
tends: tends
spreading: spreading
granular: granular
located: located
psp: psp
administrator: administrator
disturbance: disturbance
thinning: thinning
poll: polls
comic: comic
despite: despite
neurotransmitter: neurotransmitters
radish: radish
husk: husks
graduating: graduating
transformed: transformed
specifically: specifically
bushel: bushel
household: household households
dermnet: dermnet
oversaturated: oversaturated
mealtime: mealtime
tangible: tangible
appreciation: appreciation
cheated: cheated
arrangement: arrangement arrangements
uncarbonated: uncarbonated
hopeful: hopeful
pine: pine
tied: tied
enable: enable
trackpads: trackpads
strategy: strategy strategies
deadly: deadly
password: passwords password
player: players player
sample: samples sample
worse: worse
bending: bending
stimming: stimming
limited: limited
peasant: peasants
memorable: memorable
entitled: entitled
miller: miller
deposit: deposits deposit
managing: managing
congratulating: congratulating
automatically: automatically
examining: examining
connected: connected
levelheaded: levelheaded
counter: counter
uploaded: uploaded
wise: wise
physically: physically
adrenaline: adrenaline
becoming: becoming
doll: doll
preheated: preheated
promoter: promoter promoters
enticing: enticing
traumatized: traumatized
plunge: plunge
obtaining: obtaining
cramp: cramps
acknowledging: acknowledging
jumping: jumping
brief: briefs brief
attire: attire
dominant: dominant
promotional: promotional
participate: participate
unbearable: unbearable
dim: dim
neuropathy: neuropathy
expensive: expensive
propagate: propagate
conservative: conservative
likely: likely
badly: badly
ibs: ibs
canopy: canopy
reality: reality
twice: twice
shooting: shooting
hiking: hiking
immoral: immoral
newborn: newborn
spillage: spillage
nutmeg: nutmeg
ban: ban
pessimistic: pessimistic
fret: fret
folate: folate
cardboard: cardboard
drizzle: drizzle
almost: almost
thankfully: thankfully
innovative: innovative
singe: singe
teen: teens teen
analogue: analogue
addressed: addressed
placing: placing
pull: pull
visualization: visualization
hurtful: hurtful
embark: embark
intervention: intervention
mi: mi
equivalent: equivalent
gripping: gripping
throughout: throughout
craft: craft
october: october
spatial: spatial
venting: venting
nod: nod
inside: inside
disagrees: disagrees
sate: sate
buenas: buenas
discharge: discharge
around: around
freak: freak
peaceful: peaceful
pounding: pounding
wide: wide
nc: ncs
p: p
unrelated: unrelated
survival: survival
slows: slows
cricoid: cricoid
feather: feathers feather
lapse: lapses
cutter: cutters cutter
running: running
focused: focused
recovering: recovering
loudly: loudly
scoot: scoot
syndrome: syndrome
punctured: punctured
pareto: pareto
inspiration: inspiration
awesome: awesome
bolder: bolder
haircutting: haircutting
bark: bark
daniel: daniel
buttock: buttocks
convert: convert
informs: informs
infant: infant
pec: pec
elliott: elliott
infringement: infringement
people: people
flea: fleas flea
sends: sends
squirrel: squirrel
smell: smell smells
toddler: toddler
misleading: misleading
hairdryer: hairdryer
perish: perish
paler: paler
recurring: recurring
future: future
sliding: sliding
tired: tired
however: however
petting: petting
pepper: pepper peppers
fee: fees fee
fun: fun
misplaced: misplaced
aligns: aligns
pour: pour
button: button buttons
explanation: explanation explanations
argue: argue
thousand: thousands
sustainable: sustainable
deeper: deeper
louse: lice
basketball: basketballs basketball
treat: treats treat
courtesy: courtesy
cancel: cancels cancel
notice: notice
gay: gay
download: download
scaly: scaly
accessing: accessing
broadway: broadway
continuous: continuous
seafood: seafood
nevada: nevada
connotation: connotation
supongo: supongo
sway: sway
closely: closely
rupture: rupture ruptures
peripheral: peripheral
congress: congress
essay: essay
new: new
active: active
worst: worst
frampton: frampton
nail: nail nails
sandy: sandy
vectra: vectra
bracing: bracing
dorm: dorm
pill: pill pills
prevalent: prevalent
guarantee: guarantee
turmeric: turmeric
pelvic: pelvic
stirring: stirring
internet: internet
mucor: mucor
overseas: overseas
slider: slider
develops: develops
disgusting: disgusting
cheese: cheese
regularly: regularly
accepts: accepts
doable: doable
waterproof: waterproof
aware: aware
sound: sound sounds
incurring: incurring
clockwise: clockwise
thyroid: thyroid
battery: battery
compressed: compressed
edutopia: edutopia
heston: heston
wheel: wheel wheels
prof: proves
lumber: lumber
grown: grown
away: away
huge: huge
cantaloupe: cantaloupe
dig: dig
odds: odds
unsealed: unsealed
liable: liable
preparation: preparation
md: md
full: full
recap: recap
accusation: accusation
caregiver: caregivers caregiver
sleeplessness: sleeplessness
mkv: mkv
provided: provided
recipient: recipients recipient
alter: alter
confuse: confuse
transferring: transferring
footwear: footwear
barren: barren
slack: slack
skimmed: skimmed
nitrite: nitrite
expect: expect
sarcoptic: sarcoptic
operation: operations
guide: guide
foil: foil
compost: compost
resuming: resuming
position: positions position
spacing: spacing
predetermined: predetermined
audacity: audacity
promote: promote
handy: handy
algae: algae
ratified: ratified
moist: moist
shepherd: shepherd
reinforce: reinforce
shorter: shorter
forgot: forgot
jennifer: jennifer
apple: apple apples
okay: okay
chewable: chewable
yoga: yoga
buying: buying
fixed: fixed
lauryl: lauryl
accumulating: accumulating
curl: curl
lightly: lightly
duty: duty
opt: opt
shared: shared
fume: fumes
reconnect: reconnect
undesirable: undesirable
dormant: dormant
mastered: mastered
straightened: straightened
respond: respond
meaty: meaty
anonymous: anonymous
visually: visually
professionalism: professionalism
along: along
dy: dies
creature: creatures
latter: latter
disrupt: disrupt
frequency: frequency
unimportant: unimportant
solve: solve
contest: contest
succeeded: succeeded
cooperatively: cooperatively
scorching: scorching
sulphur: sulphur
dab: dab
dosage: dosages dosage
obstructed: obstructed
exists: exists
unsnap: unsnap
making: making
praying: praying
task: task tasks
spoon: spoons spoon
jog: jog
ak: ak
oval: oval
hazard: hazard hazards
gunky: gunky
tenderize: tenderize
referred: referred
sterilize: sterilize
agency: agency
presumptuous: presumptuous
interest: interests interest
epsom: epsom
buddy: buddies buddy
effectsーsuch: effectsーsuch
digested: digested
digestion: digestion
profanity: profanity
crumble: crumble
component: components component
cup: cups cup
chicken: chicken
condemn: condemn
certainly: certainly
barge: barge
blueberry: blueberries
boxing: boxing
going: going
malnutrition: malnutrition
assembly: assembly
attache: attaches
royal: royal
washing: washing
possible: possible
fecal: fecal
dealership: dealership dealerships
ground: ground
uti: uti
hidden: hidden
humiliate: humiliate
preheat: preheat
flavoring: flavoring
happening: happening
polyethylene: polyethylene
deepens: deepens
swiveling: swiveling
analysis: analysis
puff: puffs
olive: olive
clothing: clothing
music: music
android: android
highlighting: highlighting
sentimental: sentimental
bit: bit bits
afterwards: afterwards
selfie: selfie
multicolored: multicolored
stove: stove
advises: advises
fan: fan fans
adherence: adherence
professionally: professionally
url: url
survey: survey
give: give gives
painter: painters painter
germinated: germinated
sided: sided
spiritual: spiritual
dependent: dependent
gotten: gotten
ai: ai
refrain: refrain
softly: softly
triggering: triggering
delay: delay
battle: battles battle
continued: continued
challenge: challenges challenge
riskiest: riskiest
installing: installing
judgment: judgment judgments
honor: honor
antioxidant: antioxidants
drowsy: drowsy
enunciate: enunciate
glob: glob
different: different
prostate: prostate
skipped: skipped
programmed: programmed
milestone: milestones
qualify: qualify
elevate: elevate
prove: prove
statistic: statistic
cliche: cliches
breading: breading
underscore: underscores
concluded: concluded
organize: organize
repaired: repaired
fencing: fencing
contraction: contractions
plate: plates plate
sideways: sideways
coworkers: coworkers
wrong: wrong
weighted: weighted
trachea: trachea
bar: bars bar
sickle: sickle
meantime: meantime
lastly: lastly
fascinating: fascinating
throat: throat
violation: violation
removing: removing
awkward: awkward
enlargement: enlargement
softens: softens
tightening: tightening
essential: essential
tutor: tutor
scrub: scrubs scrub
adhere: adhere
barley: barley
bullied: bullied
michele: michele
contain: contain
chew: chew
building: building buildings
pritchard: pritchard
feeding: feeding
anal: anal
young: young
excrete: excrete
absorbs: absorbs
copyrighted: copyrighted
screwdriver: screwdriver
insulted: insulted
trip: trip trips
pyriproxyfen: pyriproxyfen
discus: discuss
cuff: cuff cuffs
trunk: trunk
iodine: iodine
specializing: specializing
would: would
drooping: drooping
ambitious: ambitious
baking: baking
needle: needle
meaningfully: meaningfully
collect: collect
rugged: rugged
venture: venture
multivitamin: multivitamins
complete: complete
clench: clench
clamp: clamp clamps
rag: rag rags
drastic: drastic
differently: differently
drugstore: drugstore
answered: answered
imprint: imprint
reusable: reusable
publishing: publishing
suck: suck
killed: killed
fast: fast
dispose: dispose
animal: animal animals
producing: producing
accidental: accidental
algal: algal
cassette: cassette
soaking: soaking
pink: pink
periodic: periodic
gym: gym
make: makes make
shop: shops shop
incurable: incurable
density: density
mistake: mistakes mistake
beat: beat beats
apartment: apartment
castor: castor
intended: intended
convince: convince
kneading: kneading
mixed: mixed
verbally: verbally
sear: sear
binging: binging
generate: generate
clearly: clearly
dimensional: dimensional
tropical: tropical
internalized: internalized
breakage: breakage
beet: beet
transplanted: transplanted
served: served
course: course
naturally: naturally
preview: preview
physical: physical
nauseous: nauseous
party: party parties
bold: bold
embarrass: embarrass
consistently: consistently
auto: auto
reinforcement: reinforcement
triggered: triggered
ops: ops
timeless: timeless
journey: journey
linseed: linseed
euro: euro
dirt: dirt
gross: gross
costa: costa
saucer: saucer
jonas: jonas
hasta: hasta
saltwater: saltwater
cricothyroidotomy: cricothyroidotomy
alcohol: alcohol
seven: seven
commonly: commonly
sensational: sensational
hormone: hormone
mexican: mexican
stabilizing: stabilizing
pot: pot
mind: mind
work: work works
pencil: pencils pencil
administer: administer
delivery: delivery
period: periods period
shown: shown
droop: droop
miscellaneous: miscellaneous
ra: ra
injected: injected
joining: joining
variety: varieties variety
asks: asks
corn: corn
leprosy: leprosy
carberry: carberry
influenza: influenza
nudged: nudged
almona: almona
luck: luck
kitchen: kitchen
matured: matured
cupful: cupful
respected: respected
disappeared: disappeared
crossword: crossword
pyridium: pyridium
rug: rugs
buffer: buffer
sebaceous: sebaceous
arrow: arrow arrows
pixel: pixel
dredging: dredging
vestibular: vestibular
poorly: poorly
improving: improving
otc: otc
inpatient: inpatient
mineral: minerals mineral
hopeless: hopeless
store: stores store
rope: rope
havoc: havoc
donated: donated
symptom: symptom symptoms
perfectly: perfectly
educational: educational
arrive: arrive
igrs: igrs
experienced: experienced
panicked: panicked
formation: formation
alarmed: alarmed
allow: allow
discussed: discussed
magnesium: magnesium
illustrate: illustrate
logged: logged
completes: completes
came: came
disappear: disappear
evenly: evenly
abruptly: abruptly
caramelizing: caramelizing
floor: floor floors
newer: newer
sunlight: sunlight
science: science
transaction: transactions transaction
aspirate: aspirate
hot: hot
choir: choir
spend: spend
slit: slit
flare: flare
smaller: smaller
prepared: prepared
driving: driving
kickback: kickback
viable: viable
harvested: harvested
hughes: hughes
emotion: emotions emotion
empirical: empirical
tie: ties tie
breaking: breaking
triangular: triangular
redistribute: redistribute
invalidate: invalidate
stuff: stuff
phrasebook: phrasebook
creamy: creamy
loosely: loosely
vanishing: vanishing
findlaw: findlaw
addicted: addicted
mite: mite mites
uncoil: uncoil
kart: kart
handful: handful handfuls
graded: graded
exfoliation: exfoliation
production: production
rubbing: rubbing
armpit: armpit
xp: xp
grieve: grieve
suffer: suffer
grammar: grammar
squeeze: squeeze
attention: attention
calmed: calmed
weakens: weakens
significant: significant
epicenter: epicenter
cloudiness: cloudiness
pat: pat pats
mop: mop
bromelin: bromelin
lunge: lunge
artificial: artificial
excluding: excluding
michigan: michigan
impair: impair
ear: ear ears
upward: upward
continually: continually
meltdown: meltdown meltdowns
differ: differ
framed: framed
variable: variable
negatively: negatively
obvious: obvious
enrich: enrich
violent: violent
silly: silly
overall: overall
loving: loving
recycled: recycled
contains: contains
neem: neem
exchanged: exchanged
exploded: exploded
flirt: flirt
sticking: sticking
sauce: sauce sauces
seed: seed seeds
healthier: healthier
specialty: specialties specialty
pollinated: pollinated
melody: melody
dehydrated: dehydrated
barrier: barrier
affected: affected
alternating: alternating
recommendation: recommendations
effect: effects effect
always: always
faucet: faucet
overload: overload
schedule: schedule schedules
no: nos
empathize: empathize
loosest: loosest
spouse: spouse
ecological: ecological
identification: identification
gable: gable
ordinarily: ordinarily
archive: archive
michelle: michelle
overlook: overlook
hummus: hummus
psychology: psychology
looser: looser
woe: woes
skillet: skillet
facebook: facebook
curving: curving
accessed: accessed
diffuse: diffuse
behave: behave
mrcvs: mrcvs
matching: matching
lifted: lifted
spacious: spacious
boating: boating
reservoir: reservoir
anticipated: anticipated
anywhere: anywhere
km: km
counselor: counselor counselors
opposing: opposing
sriracha: sriracha
class: classes class
sacrifice: sacrifice
overstaying: overstaying
entertainment: entertainment
lufenuron: lufenuron
fussy: fussy
controller: controller
resolve: resolve
stop: stops stop
painted: painted
toxic: toxic
upgraded: upgraded
upon: upon
disagreeing: disagreeing
coli: coli
plank: plank
hey: hey
calcium: calcium
bead: beads
stuck: stuck
aid: aid
increment: increments
activity: activity activities
vigorously: vigorously
burn: burns burn
intimate: intimate
duckweed: duckweed
steady: steady
enter: enter
disruptive: disruptive
aquatic: aquatic
seam: seam
currently: currently
pivot: pivot
maximum: maximum
indentation: indentation
vertical: vertical
mildly: mildly
surprised: surprised
pulp: pulp
greek: greek
notch: notch
review: review reviews
slender: slender
bragging: bragging
preconception: preconceptions
limber: limber
bamboo: bamboo
passionate: passionate
translation: translation
technology: technology
technical: technical
equipped: equipped
replaced: replaced
outreach: outreach
discounted: discounted
prompt: prompts prompt
resin: resin
purpose: purpose purposes
specially: specially
number: number numbers
consistent: consistent
efficient: efficient
nursery: nursery
prone: prone
six: six
gesticulating: gesticulating
labeling: labeling
congee: congee
leader: leader
appropriate: appropriate
soothing: soothing
controversy: controversy
mature: mature
instructor: instructor
separation: separation
glossy: glossy
relevancy: relevancy
dead: dead
causing: causing
send: send
joy: joy
diagnosed: diagnosed
reply: reply
trimmer: trimmers
passing: passing
unavailable: unavailable
parameter: parameters
pennsylvania: pennsylvania
conditioning: conditioning
almanac: almanac
easily: easily
detailed: detailed
duct: duct
vent: vent vents
encourages: encourages
cough: cough
expanding: expanding
benthic: benthic
nt: nt
spiky: spiky
european: european
fumbling: fumbling
classroom: classroom classrooms
identified: identified
relevant: relevant
nonprofit: nonprofit
exude: exude
understandable: understandable
outcome: outcomes outcome
fourth: fourth
tune: tunes
excreting: excreting
fails: fails
joyless: joyless
contamination: contamination
migraine: migraines
cold: cold
farmer: farmer
resume: resume
underage: underage
clicker: clicker
baker: baker
perpendicularly: perpendicularly
nervous: nervous
theme: theme
revision: revision revisions
evaluated: evaluated
convinced: convinced
mix: mixes mix
marking: markings marking
squirt: squirt
tankmates: tankmates
percent: percent
log: log
safety: safety
calling: calling
health: health
volt: volt
humanely: humanely
aggressive: aggressive
etc: etc
vaccine: vaccine vaccines
slouched: slouched
diminished: diminished
travis: travis
checking: checking
glutinous: glutinous
dubia: dubia
perch: perch
contour: contours
tenderizing: tenderizing
pistachio: pistachio
reactivity: reactivity
lying: lying
posing: posing
doggy: doggy
planted: planted
considerable: considerable
rise: rise
whatever: whatever
cascade: cascade
displayed: displayed
feminine: feminine
indicating: indicating
undead: undead
lactose: lactose
parasitic: parasitic
mentor: mentor
bro: bro
lettuce: lettuce
listen: listen
biochemicals: biochemicals
escalates: escalates
greatest: greatest
transplant: transplant
distressed: distressed
carelessness: carelessness
limitless: limitless
myelin: myelin
nice: nice
satisfies: satisfies
awhile: awhile
noticeably: noticeably
argan: argan
premium: premium
antiseptic: antiseptic
outer: outer
ample: ample
limitation: limitations
sterile: sterile
kong: kong
handcuffed: handcuffed
followed: followed
harder: harder
breed: breed breeds
alleged: alleged
slowly: slowly
friendbe: friendbe
arguing: arguing
eliminating: eliminating
moss: moss
simmering: simmering
expressed: expressed
neat: neat
marbling: marbling
info: info
scavenge: scavenge
pastry: pastry
burnt: burnt
sinkhole: sinkhole
annual: annual
wmv: wmv
desk: desk
intervene: intervene
dehydrator: dehydrator
feed: feed feeds
counsel: counsel
sustain: sustain
ringworm: ringworm
pervasive: pervasive
invading: invading
lick: lick
expose: expose
wanting: wanting
selling: selling
optional: optional
colony: colony colonies
logo: logo
overnight: overnight
gimp: gimp
bulletin: bulletin
confident: confident
laser: laser
devoted: devoted
concrete: concrete
caution: caution
optimal: optimal
tooling: tooling
pop: pop pops
lpc: lpc
g: g
tuck: tuck
angled: angled
beauty: beauty
batting: batting
lush: lush
vision: vision
chime: chime
exactly: exactly
basement: basements basement
switched: switched
contracting: contracting
itching: itching
graphic: graphics
visual: visual
offered: offered
consultant: consultant
neon: neon
listening: listening
dodgeball: dodgeball
succumb: succumb
kink: kinks
alleviate: alleviate
bonus: bonus
cracking: cracking
inexpensive: inexpensive
acidity: acidity
ashamed: ashamed
herbicide: herbicides herbicide
repetition: repetitions repetition
hyponatremia: hyponatremia
stims: stims
quicktime: quicktime
reputable: reputable
refilled: refilled
creatively: creatively
deemed: deemed
dehydrate: dehydrate
trapped: trapped
expedited: expedited
basket: basket
chose: chose
regarding: regarding
influence: influence
surviving: surviving
regression: regression
spike: spike
butane: butane
realistic: realistic
scurry: scurry
accompanied: accompanied
automated: automated
clinic: clinic
carbs: carbs
puddle: puddle
kyle: kyle
newly: newly
chicago: chicago
reorganized: reorganized
sprout: sprout
errand: errands
diagnose: diagnose
jerk: jerk
abrazo: abrazo
awareness: awareness
hotel: hotel hotels
money: money
resembles: resembles
notify: notify
release: release
education: education
sponsored: sponsored
malaise: malaise
establishment: establishments
became: became
stretch: stretch
satisfied: satisfied
following: following
snag: snags snag
match: matches match
ipod: ipod
across: across
erosion: erosion
assumes: assumes
fragranced: fragranced
injure: injure
knowledge: knowledge
preferable: preferable
plan: plan plans
awkwardness: awkwardness
vest: vests vest
friday: friday
joker: joker jokers
frankenstein: frankensteins
closer: closer
bundle: bundle
remold: remold
public: public
spca: spca
paper: papers paper
cute: cute
wool: wool
interesting: interesting
hedge: hedge
igr: igr
learning: learning
milfoil: milfoil
congeal: congeal
blankly: blankly
blue: blue
siding: siding
slimmer: slimmer
disassemble: disassemble
shrimp: shrimp
deteriorate: deteriorate
tubing: tubing
theater: theater
impressed: impressed
frequent: frequent
aggression: aggression
sharpened: sharpened
welcome: welcome
worthy: worthy
form: forms form
palate: palate
tack: tacks
monique: monique
simplified: simplified
backyard: backyard
pinching: pinching
detangling: detangling
sensitized: sensitized
breathe: breathe
herbaceous: herbaceous
enables: enables
statement: statements statement
eulogy: eulogy
punished: punished
garden: garden
shingle: shingles
gnat: gnats
manouchekian: manouchekian
bully: bully bullies
advance: advance
suggested: suggested
diagnosing: diagnosing
imagining: imagining
reprimanded: reprimanded
alfalfa: alfalfa
wire: wire wires
china: china
recycle: recycle
hairline: hairline
sediment: sediment
cycle: cycle cycles
soccer: soccer
diy: diy
injured: injured
government: government
unintentionally: unintentionally
pumpkin: pumpkins
celery: celery
moderation: moderation
colon: colon
previously: previously
productive: productive
appropriately: appropriately
replenish: replenish
care: care cares
teleportation: teleportation
abstract: abstract
utilizing: utilizing
upwards: upwards
singing: singing
fidgeting: fidgeting
tuesday: tuesday
considerate: considerate
decaf: decaf
favorite: favorite favorites
correspondence: correspondence
ilikelemons: ilikelemons
varying: varying
lowering: lowering
revenue: revenue
martial: martial
calculate: calculate
flail: flail
sanitizer: sanitizer
spicy: spicy
misguided: misguided
digging: digging
consultation: consultations
injures: injures
tackle: tackle
boldly: boldly
mobile: mobile
bowel: bowel
received: received
tail: tail
squint: squint
scoop: scoop
dilate: dilate
bread: breads bread
lift: lift
flaky: flaky
enclosing: enclosing
untangle: untangle
enemy: enemy
apprehensive: apprehensive
flashing: flashing
customary: customary
switch: switch
hammer: hammer
obviously: obviously
obnoxious: obnoxious
warning: warning warnings
laptop: laptop
misbehave: misbehave
inhabitant: inhabitants
world: world
alice: alice
thoracic: thoracic
mad: mad
boost: boost
cupboard: cupboard
wonder: wonder
twist: twists twist
nutella: nutella
constantly: constantly
rubric: rubric
renew: renew
looping: looping
personal: personal
styrofoam: styrofoam
big: big
define: define
guy: guy guys
june: june
cone: cones
restrict: restrict
assessing: assessing
urination: urination
urinary: urinary
inhaled: inhaled
applesauce: applesauce
informal: informal
v: v
bowie: bowie
billy: billy
sensitivity: sensitivities sensitivity
testicle: testicles
discolor: discolor
heartworms: heartworms
advertised: advertised
management: management
avvo: avvo
direct: direct
pollination: pollination
pinot: pinot
simple: simple
sprain: sprain
smile: smile
shock: shock shocks
commission: commission commissions
downloaded: downloaded
device: devices device
whelp: whelp
separated: separated
ryvita: ryvita
leading: leading
exchanging: exchanging
wring: wring
mouth: mouth
entirely: entirely
terrain: terrain
caldwell: caldwell
similar: similar
administration: administration
beforehand: beforehand
butthead: butthead
softener: softener
straw: straw
occasionally: occasionally
sometime: sometime
learns: learns
paperwork: paperwork
chapter: chapters chapter
dredge: dredge
wiring: wiring
advanced: advanced
cuídate: cuídate
día: día
connect: connect
fireplace: fireplace
international: international
combo: combos combo
underwater: underwater
atop: atop
crank: crank
cories: cories
pursue: pursue
based: based
uphold: uphold
available: available
tenderloin: tenderloin
analogous: analogous
funky: funky
lajii: lajii
dispute: dispute
acreage: acreage
grape: grapes
puede: puede
depart: depart
eat: eat
ppm: ppm
stack: stack
exam: exam
cube: cubes
dash: dashes dash
keyboard: keyboard
agitation: agitation
dropper: dropper
mammary: mammary
espn: espn
saying: saying
transpiration: transpiration
absence: absence
nowhere: nowhere
educate: educate
dreamed: dreamed
sawing: sawing
nut: nuts nut
abstaining: abstaining
occurs: occurs
bicep: bicep
groom: groom
superseded: superseded
limb: limb limbs
learned: learned
share: share
authority: authorities authority
bag: bags bag
identifier: identifier
continue: continue
brian: brian
dramatic: dramatic
accuracy: accuracy
dented: dented
reading: reading
makeshift: makeshift
objectively: objectively
l: l
drunk: drunk
sudomotor: sudomotor
ammonia: ammonia
healthcare: healthcare
excellent: excellent
tenderness: tenderness
remember: remember
spell: spell spells
solitary: solitary
pharmacist: pharmacist
cloth: cloth
started: started
humor: humor
shying: shying
penis: penis
starter: starter
prioritize: prioritize
gland: glands
gram: grams gram
shine: shine
slump: slump
mallet: mallet
forced: forced
promoting: promoting
tar: tar
bathtub: bathtub
light: lights light
asia: asia
optimum: optimum
photoshop: photoshop
surrounding: surrounding
rejoin: rejoin
converge: converge
aside: aside
euphemism: euphemisms
altogether: altogether
spreader: spreader
riser: risers
scholarly: scholarly
proofread: proofread
respective: respective
sable: sable
perception: perception
frequently: frequently
filed: filed
drag: drags drag
shopper: shopper
premade: premade
opened: opened
significantly: significantly
sober: sober
flailing: flailing
conscious: conscious
drip: drip drips
owned: owned
pu: pus
morning: morning
apology: apology
resisting: resisting
distinguish: distinguish
roughen: roughen
mild: mild
rolled: rolled
dishrag: dishrag
greatly: greatly
cutting: cutting
misjudged: misjudged
cheap: cheap
mahs: mahs
improvise: improvise
according: according
garment: garment
adage: adage
represents: represents
bug: bugs
headline: headlines
frighten: frighten
undies: undies
enthusiastically: enthusiastically
attacked: attacked
concentrate: concentrate
utility: utility
wisely: wisely
grill: grill
thirty: thirty
cushioning: cushioning
relaxation: relaxation
agrees: agrees
tv: tv
arlene: arlene
fna: fna
crunch: crunch
unannounced: unannounced
hamburger: hamburgers
effected: effected
rn: rn
invertebrate: invertebrates
refraining: refraining
brace: brace
sausage: sausage
properly: properly
payne: payne
creator: creators creator
killing: killing
hesitate: hesitate
publish: publish
thick: thick
clearance: clearance
comedian: comedians
gun: gun
uncovered: uncovered
non: non
treated: treated
pjs: pjs
relapse: relapse
professor: professors professor
towards: towards
numbness: numbness
login: login
importing: importing
blame: blame
fulton: fulton
spoilage: spoilage
unblinking: unblinking
tech: tech
melted: melted
lymphosarcoma: lymphosarcoma
smash: smash
roofing: roofing
adopt: adopt
helmet: helmet
motivated: motivated
coverage: coverage
trim: trim
canned: canned
inevitable: inevitable
accent: accent
browned: browned
pulsating: pulsating
admission: admissions
fracture: fractures
congratulation: congratulations
chat: chat
hybrid: hybrids
dilation: dilation
likelihood: likelihood
investment: investment
proceeding: proceeding
authentically: authentically
irritate: irritate
watercolor: watercolor
pry: pry
jamb: jamb
sizeable: sizeable
decreasing: decreasing
admitting: admitting
sit: sit
wallet: wallet
sister: sister sisters
fingertip: fingertip
delicate: delicate
cylinder: cylinders
scare: scare
venue: venue
relieve: relieve
english: english
conviction: convictions
bloodworm: bloodworms
lgbt: lgbt
viewed: viewed
veo: veo
withstand: withstand
tossing: tossing
dealt: dealt
gasping: gasping
visa: visa
unroll: unroll
nickname: nickname
currency: currency currencies
appearance: appearances appearance
dullness: dullness
gina: gina
unsure: unsure
shaping: shaping
stamp: stamp
plunger: plunger
timing: timing
slouching: slouching
rich: rich
thrives: thrives
implication: implications
pox: pox
foggy: foggy
wildlife: wildlife
bristle: bristles
fungicide: fungicide
avoiding: avoiding
grow: grow
best: best
invite: invite
basin: basin
mourning: mourning
criminal: criminal
patchy: patchy
pleasant: pleasant
value: value values
proximity: proximity
thicken: thicken
designing: designing
predecessor: predecessor
interviewing: interviewing
compassionately: compassionately
escalated: escalated
intimidating: intimidating
assertive: assertive
disturbing: disturbing
adoption: adoption
failure: failure failures
staring: staring
unpleasant: unpleasant
laughing: laughing
thank: thank
minnesota: minnesota
jay: jay
additionally: additionally
preference: preferences preference
regroup: regroup
buy: buy
everybody: everybody
jealousy: jealousy
hall: hall
dealing: dealing
bloodthirsty: bloodthirsty
coiled: coiled
garnishing: garnishing
dehydrating: dehydrating
pressed: pressed
belittles: belittles
unexpected: unexpected
abusing: abusing
removable: removable
ounce: ounce ounces
altering: altering
kiwi: kiwi
vaginitis: vaginitis
bottled: bottled
become: become
broiling: broiling
whispering: whispering
speeding: speeding
jar: jar jars
wax: wax
venous: venous
hollowed: hollowed
incorporating: incorporating
trustworthy: trustworthy
completely: completely
still: stills still
particularly: particularly
reactive: reactive
numerous: numerous
fanfiction: fanfiction
easy: easy
seasoned: seasoned
folk: folks
protection: protection
inflate: inflate
burden: burdens
depends: depends
cure: cure
thrown: thrown
hatch: hatch
mowing: mowing
said: said
either: either
background: background
opting: opting
hunched: hunched
interrupt: interrupt
squeamish: squeamish
flow: flow
matuska: matuska
mueller: mueller
bothered: bothered
scouring: scouring
reapplied: reapplied
quinoa: quinoa
woolf: woolf
absorb: absorb
lengthen: lengthen
gi: gi
potting: potting
respecting: respecting
guaranteed: guaranteed
chalk: chalk
dissect: dissect
slip: slip
star: star
felt: felt
steadily: steadily
devote: devote
jack: jack
cooking: cooking
go: go goes
hardly: hardly
sans: sans
overturned: overturned
stopped: stopped
withdraw: withdraw
sudoku: sudoku
swinging: swinging
napping: napping
tracking: tracking
stubby: stubby
vulnerable: vulnerable
pause: pause
sex: sex
typical: typical
shout: shout
counsellor: counsellor
escalating: escalating
vibe: vibe
driver: drivers driver
dampen: dampen
violating: violating
bloodstream: bloodstream
yearn: yearn
perennial: perennials
returned: returned
firstly: firstly
greenhouse: greenhouse
millet: millet
stretching: stretching
affix: affix
washable: washable
respectfully: respectfully
securing: securing
windowsill: windowsill
paid: paid
comfortis: comfortis
itchy: itchy
availability: availability
carving: carving
illusion: illusion
overlooked: overlooked
placed: placed
arrogance: arrogance
iris: iris
forge: forge
stationary: stationary
toy: toys toy
ebook: ebook
replacing: replacing
eyebrow: eyebrows
fighter: fighters
scream: scream
strain: strain
unattended: unattended
eraser: eraser
uk: uk
adding: adding
distance: distance distances
ant: ants
file: file files
celebratory: celebratory
court: court
guardian: guardian
ponytail: ponytails ponytail
detaching: detaching
perpendicular: perpendicular
represent: represent
holding: holding
follow: follow
perform: perform
concerning: concerning
tab: tab tabs
latin: latin
unlock: unlock
martin: martin
watching: watching
nintendo: nintendo
strive: strive
combustible: combustible
nonchalant: nonchalant
sleep: sleep
unchecked: unchecked
clomipramine: clomipramine
breathing: breathing
theatre: theatre
alateen: alateen
variation: variation variations
pe: pe
adjusted: adjusted
primary: primary
catching: catching
remembering: remembering
stroganoff: stroganoff
denatured: denatured
intends: intends
reduced: reduced
banking: banking
attaching: attaching
among: among
condensation: condensation
everyday: everyday
butterfat: butterfat
beautifully: beautifully
curtain: curtain curtains
cleveland: cleveland
bowed: bowed
collaborative: collaborative
selected: selected
curious: curious
respirator: respirator
pushy: pushy
snow: snow
getting: getting
approve: approve
god: god
toss: toss
prong: prongs
seems: seems
destructive: destructive
westchester: westchester
willing: willing
muscular: muscular
unwanted: unwanted
protect: protect
freezer: freezer
infect: infect
coming: coming
browse: browse
centimeter: centimeters
mayo: mayo
zucchini: zucchini
damaging: damaging
craigslist: craigslist
initial: initial
wave: wave
depending: depending
protrude: protrude
document: document documents
wear: wear
dave: dave
tight: tight
roughly: roughly
ceiling: ceiling
email: email emails
spain: spain
vibration: vibration
laughed: laughed
friendship: friendships
iron: iron
myth: myth
highest: highest
afflicted: afflicted
colored: colored
wondering: wondering
critical: critical
sleeping: sleeping
dismissing: dismissing
orally: orally
copyright: copyright
even: even
deadhead: deadhead
trait: traits
slice: slice
caramelizes: caramelizes
sizing: sizing
jumper: jumpers
launch: launch
accepted: accepted
videoread: videoread
saludos: saludos
complain: complain
checkbox: checkbox
constant: constant
escaped: escaped
submitting: submitting
lloyd: lloyd
cordial: cordial
registered: registered
mourner: mourners
poison: poisons
timer: timer
reassemble: reassemble
legally: legally
worrying: worrying
band: bands band
subtle: subtle
prefer: prefer
carrying: carrying
smoking: smoking
spitting: spitting
neuroma: neuroma
sincerely: sincerely
classified: classified
trail: trail trails
incision: incision
advised: advised
agility: agility
although: although
counting: counting
acetylene: acetylene
kicker: kicker
roast: roast
imperative: imperative
retention: retention
disconnected: disconnected
shrinking: shrinking
pass: passes
youngest: youngest
socializing: socializing
neonicotinoid: neonicotinoid
eric: eric
governed: governed
constipation: constipation
ask: ask
gel: gel
remnant: remnants
steaming: steaming
sickness: sicknesses
dough: dough
leaky: leaky
corrigan: corrigan
fever: fever
crohn: crohn
identical: identical
hopefully: hopefully
notion: notion
heal: heal
becomes: becomes
obstructing: obstructing
survive: survive
standing: standing
cmyk: cmyk
aggravate: aggravate
eradicated: eradicated
inserting: inserting
retain: retain
sens: senses
discomfort: discomfort
packed: packed
higher: higher
fake: fake
combine: combine
resentment: resentment
produce: produce
object: object objects
stockpile: stockpile
defend: defend
print: print
coxprofessional: coxprofessional
audio: audio
grinder: grinder
agitate: agitate
bunching: bunching
bun: bun
hind: hind
news: news
stress: stress
repeating: repeating
cautiously: cautiously
society: society
airtight: airtight
cross: cross
jail: jail
oozing: oozing
ml: ml
wary: wary
hat: hat
countdown: countdown
smoothy: smoothies
convenience: convenience
uncooked: uncooked
orphaned: orphaned
autonomic: autonomic
hay: hay
farthest: farthest
clerk: clerk
institution: institution
mount: mount
gratitude: gratitude
nope: nope
risk: risk
roam: roam
truth: truth
sturdiness: sturdiness
krita: krita
single: single
selecting: selecting
hepatitis: hepatitis
disinfectant: disinfectant
respiratory: respiratory
being: beings
potato: potatoes
definition: definition
meter: meter
ambulance: ambulance
canal: canal
least: least
evaporate: evaporate
spanish: spanish
shortness: shortness
panty: panty
disorganized: disorganized
drug: drugs drug
tougher: tougher
teasing: teasing
detach: detach
tense: tense
mildew: mildew
washington: washington
al: al
quantitative: quantitative
forward: forward
unusually: unusually
man: man
milk: milk
throwing: throwing
inspector: inspectors
upper: upper
overcome: overcome
cpr: cpr
noxious: noxious
courteous: courteous
harming: harming
hint: hints
twisted: twisted
chlamydophila: chlamydophila
producer: producer
appendage: appendages
slumping: slumping
inflammatory: inflammatory
sandvick: sandvick
internationally: internationally
jumpy: jumpy
energetic: energetic
bat: bat
greater: greater
dislodging: dislodging
tank: tank
national: national
urethral: urethral
explained: explained
nightshade: nightshades nightshade
ship: ships
ultrasound: ultrasound
minister: minister
untreated: untreated
excited: excited
distress: distress
foreground: foreground
tofu: tofu
textured: textured
frightening: frightening
confidently: confidently
path: path
slipping: slipping
peat: peat
arranging: arranging
commercial: commercial
motor: motor
thrift: thrift
proficient: proficient
arguably: arguably
chooses: chooses
restart: restart
convey: convey
routinely: routinely
intensity: intensity
collecting: collecting
irresponsible: irresponsible
ibuprofen: ibuprofen
whole: whole
tipping: tipping
effective: effective
cashew: cashews
ribeye: ribeye
microwaveable: microwaveable
meaning: meaning
slower: slower
taught: taught
wongleadership: wongleadership
resign: resign
deflate: deflate
caterpillar: caterpillars
gesture: gesture
autism: autism
degrade: degrade
gangrene: gangrene
ensure: ensure
guyana: guyana
recover: recover
rapidly: rapidly
recur: recur
changed: changed
ruler: ruler
flourishing: flourishing
buyer: buyer buyers
pansexual: pansexual
ownership: ownership
richer: richer
differs: differs
mañana: mañana
positive: positive
carefully: carefully
largest: largest
heard: heard
grounded: grounded
watertight: watertight
smoother: smoother
lentil: lentil lentils
germination: germination
anger: anger
ten: ten
tongue: tongue
intestinal: intestinal
hardware: hardware
somewhere: somewhere
pride: pride
smallest: smallest
malt: malt
kick: kick
rubbery: rubbery
traumatic: traumatic
turkey: turkeys turkey
occurred: occurred
rude: rude
foundational: foundational
martes: martes
angelfish: angelfish
market: market
interact: interact
pelvis: pelvis
consult: consult
submersed: submersed
perimeter: perimeter
champion: champions
branch: branch
untangled: untangled
heartwarming: heartwarming
guidance: guidance
supersized: supersized
anime: anime
pesticide: pesticides
compassion: compassion
second: second seconds
curled: curled
consistency: consistency
malaria: malaria
converting: converting
chao: chao
forgo: forgo
sugar: sugar
deepening: deepening
patricia: patricia
responsive: responsive
metadata: metadata
optionally: optionally
ginger: ginger
chopped: chopped
hesitant: hesitant
interface: interface
hemp: hemp
plugging: plugging
neurologist: neurologist
slacking: slacking
filling: filling
beak: beak
frizzling: frizzling
prime: prime
reflected: reflected
logically: logically
vary: vary
dislocation: dislocations
april: april
petted: petted
liking: liking
backstop: backstop
quicker: quicker
liability: liability
journal: journal
kelley: kelley
cope: cope
bearing: bearing
editing: editing
addict: addict
elevated: elevated
lily: lilies
gardener: gardener
highlight: highlight
lightweight: lightweight
quartz: quartz
banned: banned
able: able
indenting: indenting
minimizing: minimizing
phantom: phantom
ie: ie
arduous: arduous
spectrum: spectrum
workbench: workbench
sunday: sunday
breeding: breeding
bother: bothers
siempre: siempre
iphone: iphone
verbena: verbena
ripple: ripples
directly: directly
navel: navel
observe: observe
bulb: bulbs
propagating: propagating
posting: posting
gold: gold
serious: serious
fatty: fatty
seminar: seminars
philanthropy: philanthropy
lunch: lunch
lecture: lectures
striped: striped
sprawling: sprawling
broth: broth
vacation: vacation
steroid: steroids
scrubbed: scrubbed
cultivating: cultivating
lasting: lasting
unnaturally: unnaturally
sturdy: sturdy
slumped: slumped
applicable: applicable
defrosted: defrosted
smoothie: smoothie
select: select
abrasive: abrasive
necessary: necessary
fire: fire fires
overwhelming: overwhelming
leafy: leafy
filename: filename
coherent: coherent
friend: friends friend
loin: loin
electric: electric
vemos: vemos
scrambled: scrambled
injecting: injecting
wart: warts
hanging: hanging
ago: ago
wandering: wandering
incorrectly: incorrectly
fasten: fasten
plumbing: plumbing
rare: rare
interior: interior
measuring: measuring
kramer: kramer
turned: turned
modern: modern
strict: strict
draggy: draggy
antimicrobial: antimicrobial
pronoun: pronouns
traffic: traffic
transmitted: transmitted
unfolding: unfolding
admit: admit
depreciation: depreciation
allergen: allergens
reciprocity: reciprocity
reducing: reducing
obsession: obsession
stacked: stacked
oxide: oxide
agriculture: agriculture
mistaken: mistaken
trust: trust
loan: loan
sunflower: sunflower
mm: mm
economy: economies
whereas: whereas
reasonable: reasonable
jut: juts
precise: precise
rake: rake rakes
stressful: stressful
formal: formal
neutral: neutral
salmonella: salmonella
lengthwise: lengthwise
punctuated: punctuated
filtered: filtered
purchase: purchase
warm: warm
tilt: tilt
eight: eight
stair: stairs
totally: totally
café: café
initially: initially
attached: attached
tenderizer: tenderizer
grooming: grooming
memorial: memorial
tearing: tearing
caters: caters
ineffective: ineffective
experiment: experiment
helped: helped
saved: saved
driven: driven
low: low
sourced: sourced
luego: luego
renting: renting
oratorical: oratorical
mac: mac
hugging: hugging
bourquin: bourquin
headed: headed
west: west
dermatology: dermatology
axis: axis
shipped: shipped
toggle: toggle
completion: completion
pantry: pantry
decline: declines decline
solar: solar
registration: registration
youthful: youthful
stylus: stylus
hardest: hardest
partially: partially
swimmer: swimmers swimmer
disconnect: disconnect
lien: liens
inaccessible: inaccessible
harborage: harborage
rent: rent
kelly: kelly
independent: independent
experiencing: experiencing
comment: comment comments
domesticated: domesticated
harmonious: harmonious
harm: harm
kottke: kottke
painful: painful
lost: lost
paraphernalia: paraphernalia
blocking: blocking
distinguished: distinguished
chill: chills
flyer: flyers
lp: lp
stewed: stewed
upgrade: upgrade
tardy: tardy
generalized: generalized
usd: usd
deviate: deviates
conform: conform
deleting: deleting
outward: outward
pectoral: pectoral
indoors: indoors
acting: acting
secure: secure
presence: presence
strongly: strongly
advertising: advertising
ulceration: ulceration
feast: feast
maybe: maybe
subsoil: subsoil
increased: increased
bringing: bringing
paralyzed: paralyzed
sensory: sensory
advisor: advisor
aromatherapy: aromatherapy
sloping: sloping
claiming: claiming
follows: follows
invest: invest
continuing: continuing
shear: shears
massive: massive
overproduction: overproduction
acquire: acquire
ante: ante
delivers: delivers
rated: rated
waist: waist
gloved: gloved
intending: intending
scroll: scroll
colander: colander
die: die
contact: contacts contact
grief: grief
determine: determine
substantially: substantially
shutdown: shutdowns
described: described
neutered: neutered
handing: handing
interferes: interferes
advantageous: advantageous
default: default
capanelli: capanelli
compromising: compromising
equal: equals equal
exception: exception
playful: playful
apa: apa
confirmed: confirmed
rainforest: rainforest
online: online
handed: handed
named: named
clump: clumps
eaten: eaten
feeder: feeder
stressing: stressing
stinky: stinky
day: day days
acknowledgment: acknowledgment
sweatpants: sweatpants
crouch: crouch
responsible: responsible
jason: jason
chased: chased
pastime: pastime
grower: growers
goodbye: goodbye
scissors: scissors
planning: planning
ballpoint: ballpoint
iodized: iodized
publisher: publisher
hatched: hatched
darlene: darlene
colorado: colorado
speaking: speaking
transportation: transportation
individually: individually
encouraged: encouraged
recuperating: recuperating
effectively: effectively
apricot: apricot
spiderwebs: spiderwebs
supported: supported
extracting: extracting
bay: bay
honest: honest
manual: manual
selection: selection
sitz: sitz
grammatical: grammatical
kg: kg
sponge: sponge
bush: bush
cranny: crannies
cramping: cramping
insists: insists
functioning: functioning
demuro: demuro
poultry: poultry
glowing: glowing
stereotype: stereotypes
earth: earth
shaped: shaped
minor: minor
alongside: alongside
inspect: inspect
prey: prey
cordially: cordially
someday: someday
every: every
irritation: irritation
funeral: funeral
cycling: cycling
tag: tags tag
neuter: neuter
loss: loss
dust: dust
traditional: traditional
diarrhea: diarrhea
tay: tay
drooling: drooling
license: license licenses
outgrow: outgrow
advise: advise
unfortunate: unfortunate
insecure: insecure
preventing: preventing
temporary: temporary
washcloth: washcloth
knuckle: knuckles
enough: enough
wizard: wizard
super: super
frankreich: frankreich
splashing: splashing
suffocation: suffocation
twig: twig
appealing: appealing
follower: followers
identify: identify
sky: sky
confirm: confirm
noisy: noisy
incorrect: incorrect
sealing: sealing
decadent: decadent
cordialmente: cordialmente
hovig: hovig
spayed: spayed
registering: registering
freely: freely
stopper: stopper
necessarily: necessarily
happier: happier
bangladesh: bangladesh
publicly: publicly
met: met
mileage: mileage
cradle: cradle
limping: limping
macos: macos
runoff: runoff
grueling: grueling
strand: strands
thanksgiving: thanksgiving
connective: connective
circuit: circuit
pointing: pointing
alignment: alignment
ripe: ripe
boring: boring
winner: winner
exert: exert
beneath: beneath
acknowledgement: acknowledgement
elastic: elastic
disrupting: disrupting
snugly: snugly
rep: reps
resident: residents
stimulation: stimulation
tragedy: tragedy
construct: construct
fastest: fastest
strange: strange
humiliates: humiliates
confirmation: confirmation
digital: digital
stretched: stretched
completing: completing
fellow: fellow
incur: incur
aback: aback
ctrl: ctrl
surfer: surfer
hi: hi
allows: allows
ferry: ferry
far: far
defeated: defeated
scenario: scenario
que: que
noticeable: noticeable
neuropathic: neuropathic
c: c
emg: emg
appreciate: appreciate
suds: suds
remolding: remolding
temporarily: temporarily
may: may
collected: collected
trying: trying
freaking: freaking
unscrewed: unscrewed
uncertainty: uncertainty
since: since
relation: relation
fist: fist
abbreviation: abbreviation
connector: connector connectors
belongs: belongs
omit: omit
overt: overt
hashtags: hashtags
receive: receive
ab: abs
signing: signing
arise: arise
stated: stated
restoring: restoring
nohs: nohs
rdi: rdi
better: better
tackling: tackling
exist: exist
usda: usda
maintained: maintained
tend: tend
happened: happened
rectal: rectal
exfoliating: exfoliating
substantial: substantial
earliest: earliest
windshield: windshield
fiberglass: fiberglass
embedded: embedded
week: week weeks
airplane: airplane
bayer: bayer
envelope: envelope
insufficient: insufficient
temple: temples
struggling: struggling
engine: engine
team: team
shinier: shinier
prompted: prompted
regulator: regulator
lack: lack
kiosk: kiosks
warranted: warranted
crawl: crawl
third: third
constricts: constricts
clearer: clearer
participation: participation
dehydration: dehydration
goggles: goggles
sizzling: sizzling
voiceover: voiceover
enjoyable: enjoyable
organization: organization organizations
educator: educators
bankruptcy: bankruptcy
anyone: anyone
made: made
order: order
guidestar: guidestar
rebuild: rebuild
weekly: weekly
recommend: recommend
sterilization: sterilization
compression: compressions
alright: alright
purging: purging
refocus: refocus
outdated: outdated
waive: waive
tiktok: tiktok
edit: edit
wong: wong
mute: mute
imago: imagines
height: height
adequate: adequate
itunes: itunes
marble: marble
thoughtful: thoughtful
associated: associated
undermine: undermine
registry: registry
escaping: escaping
nausea: nausea
appraisal: appraisal
offense: offenses
anyway: anyway
madam: madam
discovering: discovering
behalf: behalf
funnel: funnel
skin: skin
fatigue: fatigue
ate: ate
contributes: contributes
kelp: kelp
ventilation: ventilation
flavour: flavour
addicting: addicting
wingless: wingless
terrible: terrible
cleanse: cleanse
accepting: accepting
whoever: whoever
fleshed: fleshed
casing: casing
within: within
ordering: ordering
shift: shift
reanimated: reanimated
rarely: rarely
golden: golden
kissing: kissing
series: series
physic: physics
removed: removed
choreograph: choreograph
rustling: rustling
quirk: quirks
reciprocal: reciprocal
churning: churning
rigid: rigid
unclip: unclip
watched: watched
moisturized: moisturized
authorship: authorship
burrowing: burrowing
triathletes: triathletes
seek: seek
army: army
cattail: cattails
rotting: rotting
noon: noon
ecstatic: ecstatic
detachment: detachment
sketch: sketch
sure: sure
diluted: diluted
elizabethan: elizabethan
complementary: complementary
encourage: encourage
hiding: hiding
itch: itch
typically: typically
weighed: weighed
swift: swift
carnivorous: carnivorous
sitting: sitting
malicious: malicious
chunk: chunk
rice: rice
roman: roman
immerse: immerse
mimic: mimic
ignites: ignites
sexually: sexually
bugging: bugging
reinsert: reinsert
composition: composition
hess: hess
springtail: springtails
tedious: tedious
loosen: loosen
reached: reached
taper: taper
notoriously: notoriously
grows: grows
styled: styled
television: television
worthless: worthless
retains: retains
chi: chi
secondary: secondary
soapy: soapy
originality: originality
strengthening: strengthening
easier: easier
hairband: hairband
helpless: helpless
glad: glad
underneath: underneath
drought: drought
transfer: transfer
glance: glance
laugh: laugh
inflammation: inflammation
mr: mrs
seal: seal
podcast: podcast
steel: steel
smart: smart
vida: vida
paint: paint
tolerance: tolerances
teller: teller
anxiousness: anxiousness
enhance: enhance
wreck: wreck
urinate: urinate
devour: devour
execute: execute
overstay: overstay
finance: finances
toughened: toughened
violence: violence
interrogation: interrogations
prepaid: prepaid
swell: swell
annoying: annoying
celebrate: celebrate
squished: squished
indicate: indicate
ecologist: ecologist
loved: loved
consumed: consumed
solving: solving
bathe: bathe
controlling: controlling
contrast: contrast
simpler: simpler
bubbling: bubbling
commenting: commenting
elicit: elicit
droncit: droncit
exotic: exotic
doi: doi
maturity: maturity
behaving: behaving
fad: fads
medic: medics
mathew: mathew
loosened: loosened
periodically: periodically
internal: internal
overrun: overrun
rebooting: rebooting
deciding: deciding
immunity: immunity
instagram: instagram
vegetative: vegetative
shopping: shopping
moisture: moisture
packing: packing
checkmark: checkmark
sickbay: sickbay
attempting: attempting
heavier: heavier
regular: regular
smoothly: smoothly
vivarium: vivarium
sib: sib
laundry: laundry
caring: caring
unable: unable
total: total
achieving: achieving
evolved: evolved
saluda: saluda
myriad: myriad
route: route
behind: behind
hugsky: hugsky
residential: residential
bonding: bonding
handshake: handshake
schooling: schooling
overboard: overboard
anxiety: anxiety
modify: modify
mason: mason
ballet: ballet
lava: lava
afford: afford
relating: relating
dryness: dryness
aed: aed
